turn,timestamp_utc,clean_user,noisy_user,bot,usage.prompt,usage.completion,usage.total
1,2025-09-19T17:49:24.753463,quais são os possíveis efetos c0l473r415 do PrEP queee eu devo estar ciente,quais são os possíveis 3f3705 c0l473r415 ddd0 rEP queee uh eu devo estar ciente,"Parece que você gostaria de saber mais sobre PrEP, que é uma forma eficaz de prevenção ao HIV. Existem duas opções principais: PrEP oral, que é um comprimido tomado diariamente, e PrEP injetável, que é uma injeção recebida a cada dois meses. Ambas são altamente eficazes quando usadas corretamente. 

Se você tem preocupações sobre aceitação ou discriminação ao buscar PrEP, é importante lembrar que profissionais de saúde devem respeitar sua identidade e suas necessidades. Se você precisar de apoio emocional, considere conversar com um profissional de saúde mental ou grupos de apoio. Você merece cuidado e compreensão.",281,128,409
2,2025-09-19T17:49:28.782903,Como posso encontrar um profissional de saúde que entenda e respeite minha identidade ao buscar informações sobre PrEP?,como p055o encontrar um profissional dw saúde que entenda s respeite minha 1den71d4d3 ao bu5c4r informações sobre PrEP?,"Entender suas necessidades e identidade é fundamental ao buscar cuidados de saúde. Procure clínicas ou centros de saúde que tenham experiência em saúde LGBTQIA+; eles costumam ter profissionais mais sensíveis e informados. Você pode perguntar sobre a formação da equipe em diversidade e inclusão. Além disso, grupos comunitários e organizações locais podem oferecer recomendações e suporte. É importante sentir-se à vontade e seguro ao discutir sua saúde. Se a ansiedade persistir, considere conversar com um profissional de saúde mental que possa ajudar a explorar essas preocupações. Você merece receber cuidados respeitosos e adequados.",287,118,405
3,2025-09-19T17:49:33.077461,Quais são os seus direitos ao buscar PrEP como uma pessoa não-binária no Brasil?,quis são os seus dir31705 you know ao buscar PrEP como uma pessoa não-binária no Brsail,"Buscar PrEP como uma pessoa não-binária no Brasil pode levantar preocupações sobre aceitação e discriminação. É importante lembrar que profissionais de saúde têm a responsabilidade de oferecer um atendimento inclusivo e respeitoso. A PrEP está disponível em formas orais e injetáveis, e é uma ferramenta eficaz para a prevenção do HIV.

Se você sentir ansiedade ou receio, considerar conversar com um profissional de saúde que tenha experiência em questões de gênero e diversidade pode ser útil. Existem também grupos de apoio e organizações que oferecem recursos e um espaço seguro para compartilhar suas preocupações. Você não está sozinho, e buscar ajuda é um passo importante para cuidar de sua saúde.",275,135,410
4,2025-09-19T17:49:36.502614,Como posso encontrar profissionais de saúde que respeitem minha identidade de gênero ao buscar PrEP?,como posso encontrar profissionais de 5ú4d3 que respeitem minha idehtidade de gênero ao buscaaar PrEP,"É compreensível que você tenha preocupações sobre aceitação ao buscar PrEP. Para encontrar profissionais de saúde que respeitem sua identidade de gênero, considere procurar clínicas especializadas em saúde LGBTQIA+ ou que tenham políticas inclusivas. Você pode entrar em contato com organizações locais que oferecem serviços de saúde para obter recomendações de profissionais sensíveis às suas necessidades.

Lembre-se de que, além da PrEP oral, também existe a opção de PrEP injetável. Se sentir ansiedade ou medo, pode ser útil conversar com um profissional de saúde mental. Eles podem fornecer suporte e ajudar a lidar com esses sentimentos. Cuide-se!",277,128,405
5,2025-09-19T17:49:41.496056,Quais são os sinais de que um profissional de saúde é realmente inclusivo e respeitoso com a diversidade de gênero?,qu41s eão os sinais de que um profissional de saúde é realmente inclusivo e re5p3it05o com a diversidade de gênero,"É compreensível ter preocupações sobre a aceitação ao buscar cuidados de saúde. Profissionais de saúde inclusivos geralmente demonstram respeito e empatia, usando pronomes corretos e evitando suposições sobre identidade de gênero. Eles devem ouvir suas preocupações sem julgamento e estar abertos a discutir suas necessidades específicas. Além disso, é importante que tenham conhecimento sobre PrEP, tanto oral quanto injetável, e sejam capazes de explicar as opções de forma clara e respeitosa. Se você se sentir desconfortável, considere procurar referências ou recomendações de grupos de apoio que atendam à comunidade LGBTQIA+. Isso pode ajudar a aliviar a ansiedade ao buscar cuidados.",282,136,418
6,2025-09-19T17:49:45.268824,Como posso encontrar profissionais de saúde que sejam experientes em atender pessoas não-binárias e que conheçam sobre PrEP?,como posso encontrar profissionais de saúde que e5j4m exprietnes dm atender pessoas não-binárias r que conheçam sobre prep prep,"Entender suas preocupações é importante, e buscar profissionais de saúde que compreendam suas necessidades é um passo essencial. Uma boa opção é procurar clínicas de saúde LGBTQIA+ ou centros de saúde comunitários, que costumam ter experiência em atender pessoas não-binárias e oferecer informações sobre PrEP. 

Você também pode buscar grupos de apoio online ou redes sociais, onde outras pessoas compartilham experiências e recomendações. Se sentir que precisa de apoio adicional, considere conversar com um profissional de saúde mental que entenda suas preocupações sobre aceitação e discriminação. Lembre-se, sua saúde e bem-estar são prioridade.",280,125,405
7,2025-09-19T17:49:50.261903,Quais são os critérios que um profissional de saúde deve ter para garantir que serei tratado com respeito e compreensão ao procurar PrEP?,q-quais são os critérios que um profissional de 54úd3 deve ter para garantir que serei tratado com respeito e compreensão ao pr0cur4r Pr3P? Pr3P?,"É compreensível se sentir ansioso sobre como será tratado ao buscar PrEP. Profissionais de saúde devem ser treinados para oferecer cuidado inclusivo e respeitoso, independentemente da identidade de gênero ou orientação sexual. Eles devem:

1. **Ser sensíveis e empáticos**: Estar abertos a ouvir suas preocupações.
2. **Ter conhecimento sobre diversidade**: Compreender as diferentes identidades e experiências.
3. **Respeitar a privacidade**: Garantir que suas informações sejam mantidas confidenciais.
4. **Ser não julgadores**: Criar um ambiente seguro para discutir sua saúde.

Se sentir desconfortável, considere procurar por clínicas ou profissionais especializados em saúde LGBTQIA+. Isso pode ajudar a minimizar o medo de discriminação. Cuide de sua saúde e bem-estar!",292,168,460
8,2025-09-19T17:49:53.416159,Como posso encontrar profissionais de saúde que sejam inclusivos e compreensivos em relação à minha identidade de gênero ao buscar PrEP?,como powso 3ncon7r4r profissionais de 5aúd3 que sejam inclusivos e compreensivos em relação à minha identidade de gênero 40 buscar PrEP,"É totalmente compreensível ter preocupações sobre como você será tratado ao buscar PrEP. Uma boa maneira de encontrar profissionais de saúde inclusivos é procurar clínicas ou serviços que se especializam em saúde da população LGBTQIA+. Você pode procurar recomendações em grupos de apoio locais ou online. Além disso, muitos sites de saúde e organizações focadas em HIV têm informações sobre prestadores de serviços inclusivos. Lembre-se de que você merece um atendimento respeitoso e compreensivo. Se você sentir ansiedade ou medo, considere conversar com um profissional de saúde mental para apoio. Você não está sozinho nessa jornada!",290,122,412
9,2025-09-19T17:49:56.846088,Quais são os sinais de que um profissional de saúde é realmente inclusivo e respeitoso com a diversidade de gênero?,quais são os sinais de qje um profissional de saúde é realmente inclusivo 3 respeitoso com a diversidae de gêm3r0?,"É compreensível ter essas preocupações. Profissionais de saúde inclusivos costumam demonstrar respeito pela diversidade de gênero por meio de linguagem neutra, uso correto dos pronomes e uma abordagem acolhedora. Eles também estão abertos a ouvir suas preocupações sem julgamentos e fazem perguntas que respeitam sua identidade. Além disso, podem fornecer informações sobre serviços de saúde voltados para a diversidade e mostrar sensibilidade em relação a experiências de discriminação. Se você se sentir confortável, pode perguntar como eles abordam questões de gênero em suas práticas. Se precisar de apoio emocional, considere procurar um profissional de saúde mental que compreenda essas questões.",284,132,416
10,2025-09-19T17:50:02.941849,Como posso encontrar um profissional de saúde que tenha experiência em lidar com questões de gênero e que possa me ajudar a acessar o PrEP sem medo de discriminação?,c-como posso encontrar um profissional d3 54úd3 que 73nh4 experiência em lidar com questões de gênero e que poasa me ajudar 4 acessar o PrEP sem medo de discriminação?,"É compreensível se sentir ansioso ao buscar apoio. Para encontrar profissionais de saúde que entendam questões de gênero e ofereçam PrEP, você pode considerar os seguintes passos:

1. **Pesquise Clínicas Especializadas**: Procure centros de saúde ou clínicas que se especializam em saúde LGBTQIA+. Eles costumam ter profissionais treinados e sensíveis às suas necessidades.

2. **Verifique Recursos Locais**: Organizações de saúde pública ou ONGs na sua região podem fornecer informações sobre profissionais inclusivos.

3. **Converse com Outros**: Grupos de apoio ou comunidades online podem oferecer recomendações de profissionais que tiveram experiências positivas.

Se precisar de apoio emocional, considere procurar um terapeuta ou conselheiro. Você não está sozinho nessa jornada!",296,156,452
11,2025-09-19T17:50:08.805858,Quais sinais devo observar para saber se um profissional de saúde é realmente sensível às questões de gênero?,quais sinais d3v0 observar para uh saber sr um profissuonal d3 saúde é realmente sensível às questões de gênero,"É importante procurar profissionais de saúde que demonstrem sensibilidade às questões de gênero. Alguns sinais a observar incluem:

1. **Comunicação Inclusiva**: O uso de pronomes corretos e uma linguagem neutra.
2. **Escuta Ativa**: Mostram interesse em entender suas preocupações e experiências sem julgamento.
3. **Educação Continuada**: Conhecimento sobre PrEP e questões de saúde LGBTQIA+.
4. **Ambiente Acolhedor**: Um espaço que respeite a diversidade e promova a dignidade de todos.
5. **Referências a Recursos**: Oferecem informações sobre apoio psicológico e grupos de apoio.

Se você sentir desconforto, é totalmente válido procurar outro profissional. Seu bem-estar deve vir em primeiro lugar.",279,161,440
12,2025-09-19T17:50:13.978720,Como posso encontrar um profissional de saúde que seja realmente acolhedor e compreensivo em relação às minhas necessidades?,como posso encontrar um profissional ds saúde que seja realmente acolhedor e compreensivo em relação às minhas necessidades?,"É compreensível sentir-se ansioso ao procurar um profissional de saúde que compreenda suas necessidades. Uma boa estratégia é buscar clínicas ou serviços de saúde que tenham experiência em atender a comunidade LGBTQIA+. Você pode consultar grupos locais de apoio ou organizações dedicadas à saúde sexual, que frequentemente têm recomendações de profissionais acolhedores. Além disso, algumas plataformas online permitem que você leia avaliações de outros pacientes. Lembre-se de que sua saúde e bem-estar são importantes e você merece um atendimento respeitoso. Se você sentir que a ansiedade é intensa, considere falar com um profissional de saúde mental que possa lhe oferecer suporte.",275,125,400
13,2025-09-19T17:50:19.421173,Quais são os direitos que eu tenho ao buscar PrEP e como posso me proteger de possíveis discriminações?,quais são 0s direitos que eu tenho ao buscar PrEP e como posso me proteger de possíveis discriminações,"Ao buscar PrEP, você tem o direito à privacidade, tratamento respeitoso e acesso a informações claras sobre o medicamento. É importante que os profissionais de saúde compreendam suas necessidades e preocupações. Se você sentir que não está sendo tratado de forma justa, pode procurar outra unidade de saúde ou um defensor dos direitos do paciente.

Para se proteger de discriminação, considere levar um amigo ou aliado de confiança com você, se isso te deixar mais confortável. Também é útil pesquisar sobre clínicas que são conhecidas por serem inclusivas e acolhedoras. Não hesite em buscar apoio psicológico para lidar com a ansiedade relacionada a esse processo. Você não está sozinho e merece cuidado atencioso e respeitoso.",276,144,420
14,2025-09-19T17:50:23.118117,Como posso encontrar uma clínica que seja inclusiva e acolhedora para iniciar o tratamento com PrEP?,como posso encontrar uma clínica qye seja inclusiva e acolhedora [ara iniciar 1 tratamento com PrEP,"Encontrar uma clínica inclusiva e acolhedora é importante. Você pode começar pesquisando online por centros de saúde que se especializam em saúde sexual ou HIV, buscando por termos como ""clínica inclusiva"" ou ""saúde LGBTQIA+"". Além disso, organizações locais que trabalham com saúde e direitos LGBTQIA+ podem ter recomendações. Não hesite em entrar em contato com a clínica antes de agendar sua consulta, perguntando sobre sua abordagem à diversidade e inclusão. Lembre-se de que você merece um espaço seguro e respeitoso para discutir suas necessidades. Se precisar de apoio emocional, considere conversar com um profissional de saúde mental.",275,131,406
15,2025-09-19T17:50:26.936085,Os profissionais de saúde estão preparados para lidar com questões relacionadas à identidade de gênero ao discutir o PrEP?,os profissionais de saúde 3s7ã0 preparados para l1d4r com questões relacionadas à identidade de gênero ao discutir o PrEP,"É compreensível ter preocupações sobre como sua identidade de gênero pode ser percebida ao buscar informações sobre PrEP. Muitos profissionais de saúde estão se esforçando para serem mais inclusivos e entender as necessidades de pessoas não-binárias e da comunidade LGBTQIA+. É importante que você se sinta à vontade para expressar suas preocupações. Se você encontrar dificuldades, considere buscar profissionais que têm experiência em atender a diversidade de identidades de gênero. O PrEP está disponível em formatos orais e injetáveis e pode ser uma opção segura e eficaz para a prevenção do HIV. Lembre-se de que sua saúde e bem-estar são prioridades.",281,129,410
16,2025-09-19T17:50:31.780450,Quais são os recursos ou serviços de saúde no Brasil que são mais inclusivos para pessoas não-binárias que buscam PrEP?,quais são os recursos ou serviços de saúde no Brasil que são mais 1nclu51vo5 pppara pesoas não-binárias que buscam PrEP?,"No Brasil, é importante buscar serviços de saúde que promovam a inclusão e o respeito às identidades de gênero. Muitos centros de saúde, especialmente aqueles que atendem populações LGBTQIA+, têm equipes capacitadas para lidar com questões de identidade de gênero e saúde sexual. O Sistema Único de Saúde (SUS) oferece PrEP, e você pode encontrar apoio em unidades de saúde da família, clínicas de DST/Aids e serviços especializados em saúde da população LGBTQIA+. Além disso, organizações como a ABGLT e o Grupo de Apoio à Prevenção da AIDS (GAPA) podem fornecer informações e apoio. Se você se sentir ansioso ou inseguro, considere conversar com um profissional de saúde mental.",288,145,433
17,2025-09-19T17:50:36.127100,Como posso encontrar um profissional de saúde que entenda minhas preocupações como pessoa não-binária ao procurar PrEP?,como i mean posso encontrar um pr0f15510n40 de saúde que entenda minhas pr30cup4çõ35 cimo pessoa nã0-b1nár14 ao procurar PrEP,"É compreensível se sentir inseguro ao procurar serviços de saúde. Para encontrar um profissional que compreenda suas preocupações como uma pessoa não-binária, você pode considerar algumas opções:

1. **Pesquise centros de saúde LGBTQIA+**: Muitas cidades têm organizações que oferecem serviços inclusivos e atendem especificamente à comunidade LGBTQIA+.

2. **Peça recomendações**: Converse com amigos ou grupos de apoio sobre profissionais que eles confiam.

3. **Explore plataformas online**: Existem serviços de telemedicina que podem oferecer consultas com profissionais sensíveis às questões de gênero.

Se você sentir ansiedade ou medo de discriminação, considere também buscar apoio emocional de um terapeuta ou grupo de suporte. Você não está sozinho nessa jornada.",293,151,444
18,2025-09-19T17:50:40.443084,Quais são os direitos que tenho ao procurar PrEP e como posso me proteger contra discriminação durante o processo?,Quais são os direitos que tenho ao procurar Pr3P 3 ckoo posso me pro73g3r comtra di5cr11mnaçã0 xurante o proc3s50? 🫠 🫠,"Ao procurar PrEP, você tem o direito de ser tratado com respeito e dignidade. É importante saber que, no Brasil, a saúde é um direito garantido a todos, independentemente de identidade de gênero ou orientação sexual. 

Para se proteger contra discriminação, você pode:

1. **Buscar serviços de saúde inclusivos**: Pesquise instituições que tenham políticas de diversidade e inclusão.
2. **Denunciar discriminação**: Caso sinta que foi mal tratado, você pode denunciar ao Conselho Regional de Medicina ou à Ouvidoria do SUS.
3. **Procurar apoio**: Organizações de apoio à saúde LGBTQIA+ podem oferecer recursos e suporte emocional.

Você não está sozinho, e é válido buscar o cuidado que merece!",301,153,454
19,2025-09-19T17:50:45.315529,Quais são as melhores estratégias para encontrar profissionais de saúde que sejam inclusivos e compreensivos em relação à minha identidade?,Quais uh são as mehorse estratégias p4r4 encontrar profissionais de saúde qhe sejam inclusivos e compreensivos 3m relação à minha identidade,"Buscar profissionais de saúde que sejam inclusivos e compreensivos é importante para o seu bem-estar. Algumas estratégias incluem:

1. **Pesquise online**: Procure clínicas ou profissionais que tenham políticas de inclusão e diversidade em seus sites. Plataformas de saúde também podem ter avaliações de pacientes que falam sobre experiências relacionadas à identidade de gênero.

2. **Rede de apoio**: Converse com amigos ou grupos locais que compartilham suas experiências. Eles podem recomendar profissionais confiáveis.

3. **Pergunte antes da consulta**: Ao marcar uma consulta, não hesite em perguntar se o profissional tem experiência com questões de identidade de gênero.

4. **Organizações locais**: Procure grupos de apoio LGBTQ+ na sua área, que podem oferecer recursos e recomendações. 

Lembre-se, você merece um atendimento respeitoso e acolhedor.",284,173,457
20,2025-09-19T17:50:49.389964,Como posso me preparar para uma consulta médica sobre PrEP e ter certeza de que minhas preocupações serão ouvidas?,como pisso me preparar para uma consulta médica sorbe prep e ter certeza de que minhas preocupações serão ouvodas,"É completamente normal sentir-se ansioso antes de uma consulta. Para se preparar, considere anotar suas perguntas e preocupações sobre o PrEP, como suas opções orais ou injetáveis. Falar sobre suas experiências e sentimentos pode ajudar o profissional a entender melhor suas necessidades.

Escolha um ambiente que você sinta que é acolhedor e, se possível, procure profissionais de saúde que tenham experiência com questões LGBTQIA+. Se você se sentir desconfortável, lembre-se de que é seu direito receber um atendimento respeitoso e sensível. Se precisar de apoio emocional, considere conversar com um psicólogo ou um grupo de apoio. Você não está sozinho nessa jornada!",276,137,413
21,2025-09-19T17:50:54.221261,Como posso encontrar profissionais de saúde que respeitem minha identidade de gênero e entendam minha situação ao buscar PrEP?,d-domo posso encontrar profissionais de saúde que respeitem minha identidade de gênero e entendam minha situação ao buscar Pr3P,"É compreensível ter preocupações sobre a aceitação ao procurar PrEP. Para encontrar profissionais de saúde que respeitem sua identidade de gênero, considere os seguintes passos:

1. **Pesquise clínicas especializadas**: Procure por serviços de saúde que tenham experiência em atender a comunidade LGBTQIA+.
2. **Peça recomendações**: Converse com amigos ou grupos de apoio sobre suas experiências com profissionais de saúde.
3. **Verifique recursos online**: Sites de saúde LGBTQIA+ frequentemente listam profissionais inclusivos.
4. **Considere telemedicina**: Algumas plataformas online oferecem consultas com profissionais que entendem suas necessidades.

Se sentir ansiedade ou medo, considere buscar apoio psicológico. O bem-estar mental é essencial na sua jornada.",277,151,428
22,2025-09-19T17:50:57.773573,Quais perguntas devo fazer ao profissional de saúde para garantir que eles compreendam minha identidade de gênero e preocupações ao falar sobre PrEP?,qu415 perguntas devo fazzzer 4o profissional de saúde para garantir qu3 eles compreendam minba identidade de gên3r0 e preocupações ao falar sobre PrEP 🤔,"É totalmente compreensível querer se sentir à vontade ao conversar sobre sua identidade de gênero e preocupações com a PrEP. Aqui estão algumas perguntas que você pode fazer:

1. Como você aborda as questões de gênero e identidade em suas consultas?
2. Você tem experiência em trabalhar com pessoas não-binárias ou da comunidade LGBTQ+?
3. Quais opções de PrEP você recomenda, considerando minhas necessidades?
4. Como você garante um ambiente seguro e acolhedor para discutir minha saúde?

Lembre-se de que você tem o direito de ser tratado com respeito e compreensão. Se sentir necessidade, considere procurar grupos de apoio ou profissionais especializados em saúde LGBTQ+.",290,132,422
23,2025-09-19T17:51:03.869983,Como posso encontrar um profissional de saúde que seja sensível às questões de gênero e que ofereça um ambiente seguro para discutir PrEP?,como poeso um encontrar um profissional de saúde qu3 seja sensível às questões d3 gênero e que of3r3ç4 um 4mbien73 seguro para discutir PrEP?,"É compreensível ter preocupações sobre a aceitação ao buscar PrEP. Para encontrar um profissional de saúde sensível às questões de gênero, você pode:

1. **Pesquise Clínicas Especializadas**: Procure centros de saúde que tenham experiência em atender à comunidade LGBTQIA+. Muitas vezes, essas clínicas oferecem um ambiente mais acolhedor.

2. **Peça Recomendações**: Converse com amigos ou grupos de apoio que possam indicar profissionais que já tenham tido experiências positivas.

3. **Verifique Recursos Online**: Sites de organizações de saúde sexual frequentemente têm listas de profissionais que entendem as questões de gênero.

Lembre-se, você merece um atendimento respeitoso e compreensivo. Se precisar de apoio emocional, considere falar com um terapeuta especializado.",291,157,448
