turn,timestamp_utc,clean_user,noisy_user,bot,usage.prompt,usage.completion,usage.total
1,2025-09-19T17:24:16.458983,"I had a one-night stand recently and I'm really worried about HIV. Should I consider PrEP, and how can I even get it without a stable address?","i-i h4d a one-night 574nd recently anx i'm really worried about hiv. 5h0uld 1 considsr prep, and how can idk i even get it witohut a stable address? üòï","It's understandable to feel anxious after a one-night encounter. PrEP (pre-exposure prophylaxis) is a highly effective way to reduce the risk of HIV. There are both oral and injectable forms available. You don‚Äôt necessarily need a stable address to access PrEP; many clinics and organizations provide services regardless of housing status.

If you‚Äôre concerned about judgment, know that seeking preventive care is a responsible choice for your health. It might help to talk to a healthcare provider or a supportive organization that understands your situation. They can help you navigate your options without fear of stigma. Remember, you deserve support and care!",264,123,387
2,2025-09-19T17:24:19.485770,How can I find a healthcare provider who understands my concerns about judgment when discussing PrEP?,how can I find a healthcare provider who understamds my concerns about judgment when discsusing PrEP?,"Finding a supportive healthcare provider is important. You can start by looking for clinics or organizations that specialize in sexual health or HIV prevention. Many of these places focus on providing non-judgmental care. You might also consider reaching out to local NGOs or community health organizations that offer PrEP services, as they often have staff trained in addressing concerns about stigma. 

When you contact a provider, don't hesitate to express your worries about judgment; a good provider will listen and understand. If you're feeling anxious, talking to a mental health professional might also be helpful. Remember, your health is important, and you deserve compassionate care.",236,124,360
3,2025-09-19T17:24:23.203572,What should I say if someone asks me why I'm taking PrEP?,what should i say if someone like asks me why i'm taking prep?,"It's completely okay to feel anxious about sharing your choices. You can simply say that you're taking PrEP as a way to protect your health and prevent HIV. You might mention that it's a responsible choice for those who are at risk, just like using other preventive measures. Remember, your health decisions are personal, and you don‚Äôt owe anyone an explanation. If you ever feel overwhelmed, consider speaking with a professional who can help you navigate these feelings. You're not alone in this!",229,95,324
4,2025-09-19T17:24:26.221541,How can I build my confidence to talk about taking PrEP with others?,How can I build my confidence to talk about taking PrEP with ohters,"It's completely understandable to feel anxious about discussing PrEP with others. Remember, taking care of your health is a personal decision and an important step in prevention. You might start by educating yourself more about PrEP, which can empower you to share information with confidence. 

Consider talking to someone you trust who can provide support, or reach out to healthcare professionals who can offer guidance. If you feel overwhelmed, speaking with a counselor may help you work through your feelings and build self-esteem. Remember, you're not alone in this journey, and your health choices are valid.",230,112,342
5,2025-09-19T17:24:31.615485,What are some ways I can find supportive communities or resources that understand my situation with PrEP?,what are some ways I c4n find supportive communities or resuorces that understand my situation with PrEP üôÇ,"Finding supportive communities can be incredibly helpful. Here are some ways to connect with others who understand your situation:

1. **Local Health Clinics**: Many clinics offer support groups or counseling services for individuals considering PrEP.

2. **Online Forums**: Websites and social media groups focused on HIV prevention often provide a safe space to share experiences and ask questions.

3. **NGOs and Support Organizations**: Look for local organizations focused on HIV/AIDS awareness and prevention. They often have resources and community events.

4. **Peer Support Groups**: Some organizations offer peer-led groups where you can meet others who have similar experiences.

Remember, seeking support is a brave step, and you deserve to feel supported and understood.",239,143,382
6,2025-09-19T17:24:34.728255,How can I build my confidence to discuss PrEP openly without fearing judgment from others?,h0w can 1 build my confidence to d15cuss PrEP opsnly w170ut fearing judgm3n7 from others,"It's completely normal to feel anxious about discussing PrEP, especially with concerns about judgment. Remember, taking care of your health is a brave and important choice. Education about PrEP can empower you; understanding that it's a preventive option available to anyone at risk can help you feel more confident. 

Consider talking to a trusted healthcare provider or joining a support group where you can connect with others who share similar experiences. This can create a safe space to express your feelings without fear of judgment. You deserve support and understanding on your health journey!",244,106,350
7,2025-09-19T17:24:40.113781,What strategies can I use to find a supportive community that understands my concerns about taking PrEP?,what strategis can I use to find a supportive community that understands my concerns about taking PrEP? üôÇ,"Finding a supportive community can be really helpful. Here are a few strategies you might consider:

1. **Online Forums**: Look for online support groups or forums focused on HIV prevention and PrEP. They can provide a safe space to share experiences and feelings.

2. **Local Organizations**: Reach out to local NGOs or health clinics that focus on HIV education and support. They may have resources or groups where you can connect with others.

3. **Social Media**: Follow pages or groups on platforms like Facebook or Instagram dedicated to HIV awareness. Engaging with these communities can help you feel less isolated.

4. **Counseling Services**: Consider speaking with a mental health professional who can help you work through your feelings and build confidence.

Remember, you deserve support and understanding!",236,158,394
8,2025-09-19T17:24:43.171338,How can I overcome my fear of judgment when talking to others about my decision to take PrEP?,how c4n I overcome mmmy fear 0f judgm3n7 when taaalking to oth3r5 about my decision to twke PrEP ‚ÄºÔ∏è,"It's completely normal to feel anxious about discussing your health choices, especially regarding PrEP. Remember, taking care of your health is a personal decision and should be respected. You might consider starting conversations with trusted friends or family members who are supportive. Educating yourself about PrEP can also boost your confidence; knowing the facts can help you address any questions or concerns others might have.

If you find the fear of judgment overwhelming, talking to a mental health professional can be helpful. They can provide support and strategies to manage these feelings. You're taking a positive step for your health, and that's what matters most!",251,120,371
9,2025-09-19T17:24:47.946342,What are some ways to build confidence when discussing PrEP with people in my community?,waht are some ways to buipd confidence when discussing prep with people in myyy community?,"Kujenga ujasiri wakati wa kujadili PrEP na jamii yako kunaweza kuwa changamoto, lakini kuna hatua kadhaa unazoweza kuchukua:

1. **Elimu**: Jifunze kuhusu PrEP na jinsi inavyofanya kazi. Utaweza kutoa maelezo sahihi na kuondoa dhana potofu.

2. **Kujenga Mtandao**: Tafuta watu wengine wanaofanya maamuzi kama yako. Kuwa na marafiki au vikundi vya msaada kunaweza kusaidia.

3. **Kujieleza**: Fikiria jinsi unavyoweza kuelezea maamuzi yako. Tumia lugha rahisi na wazi.

4. **Kujitunza**: Kumbuka, afya yako ni muhimu. Hakuna haja ya kuhisi aibu.

Ikiwa unahitaji msaada zaidi, fikira kuzungumza na mtaalamu wa afya au mshauri. Wanaweza kusaidia katika kujenga ujasiri wako.",235,206,441
10,2025-09-19T17:24:52.072628,"Je, kuna rasilimali au vikundi vya msaada nchini Tanzania ambavyo vinaweza kunisaidia kuelewa zaidi kuhusu PrEP na kujijenga kiakili?",jeee knua rasilimali 4u vikundi vya saada nchini Tanzania ambavyo vinaweza kunisaidia kuelewa zadi kuhusu PrEP na kujijenga kiakili? üò≠ üò≠,"Niko hapa kusaidia! Katika Tanzania, kuna vikundi na rasilimali kadhaa zinazoweza kukusaidia kuelewa zaidi kuhusu PrEP na kujijenga kiakili. Unaweza kuangalia:

1. **Tanzania Commission for AIDS (TACAIDS)** - Wanatoa taarifa kuhusu HIV na huduma za afya.
2. **Watu Wote Tanzania** - Hutoa elimu na msaada kwa watu wanaoishi na HIV.
3. **Mwanamke na Maendeleo (WOMEN)** - Wanaweza kusaidia wanawake kuelewa masuala ya afya na kujenga nguvu za ndani.
4. **Kituo cha Habari na Elimu ya Afya (HIV/AIDS Resource Centre)** - Hutoa habari na rasilimali kuhusu HIV na PrEP.

Ni vyema kuzungumza na wataalamu wa afya au mshauri wa kiakili ili kupata msaada zaidi. Unastahili kupewa usaidizi bila hukumu.",257,200,457
11,2025-09-19T17:24:56.066415,Ninaweza kupata msaada wa kisaikolojia ili kushughulikia hofu yangu kuhusu maoni ya watu wengine kuhusu kuchukua PrEP?,Ninawezz kupata um msadaa wa kisaikolojia ili kushughulkia hofu ayngu kuhu5u maoni ya awwwtu wengine kuhusu kuchukua PrEP? üò≠,"Ni sawa kabisa kuhisi hofu kuhusu maoni ya wengine kuhusu kuchukua PrEP. Ni muhimu kukumbuka kwamba afya yako ni ya kwanza, na kuchukua hatua kama hizi ni muhimu kwa kujilinda. Ikiwa unahitaji msaada wa kisaikolojia, tafuta wataalamu katika eneo lako ambao wanaweza kusaidia. Pia, unaweza kuzungumza na wafanyakazi wa afya kuhusu hisia zako; wanaweza kukupa taarifa na uelewa zaidi kuhusu PrEP. Usijisikie peke yako; kuna watu wengi wanaweza kusaidia. Tafadhali zingatia kwamba ni muhimu kuweka afya yako na ustawi wako wa kiakili mbele.",257,138,395
12,2025-09-19T17:24:59.508763,"Je, kuna vikundi vya msaada au watu ambao wanaweza kunisaidia kuelewa zaidi kuhusu PrEP bila kuhisi kuhukumiwa?",je kun4 viundi vya msaada au watu ambao wanaweza kunisaidia kuelewa zaidi kuhusu PrEP bils kuhisi kuhukumiwa ü´†,"Ni muhimu kupata msaada na taarifa sahihi kuhusu PrEP bila kuhisi kuhukumiwa. Unaweza kuongea na watoa huduma za afya, kama madaktari au wauguzi, ambao wanaweza kukupa maelezo na usaidizi. Pia, kuna mashirika kama vile TACAIDS na NGOs zinazotoa elimu na msaada kuhusu HIV na PrEP. Wanaweza kukusaidia kwa njia ya faragha na kujibu maswali yako bila hukumu. Ni kawaida kuhisi wasiwasi, lakini kumbuka kwamba kuchukua hatua kwa ajili ya afya yako ni jambo la ujasiri. Ikiwa unahitaji msaada wa kitaaluma kuhusu hisia zako, tafuta mtaalamu wa afya ya akili.",247,152,399
13,2025-09-19T17:25:03.200774,"Je, ni salama kuzungumza na wauguzi au madaktari kuhusu hisia zangu kuhusu PrEP bila kuhisi kuhukumiwa?","je, ni um salaa kuzungumza na wauguzi au madaktari kuhusu hisia zangu kuhu5u PrEP bila kuhisi kuhukumiwa?","Ni kawaida kuhisi wasiwasi kuhusu kuhukumiwa unapozungumza kuhusu PrEP. Ni muhimu kujua kwamba wauguzi na madaktari wako hapo kusaidia na hawatakuhukumu. Wana uzoefu na masuala kama haya na wanaweza kukupa taarifa na msaada unaohitajika. Kujadili hisia zako na wataalamu wa afya kunaweza kukusaidia kujifunza zaidi kuhusu PrEP na jinsi inavyoweza kusaidia katika kuzuia maambukizi ya HIV. Ikiwa unahitaji msaada zaidi wa kiakili, tafuta wataalamu wa afya wa akili ambao wanaweza kusaidia katika kushughulikia wasiwasi wako. Wewe ni muhimu na unastahili huduma bora.",250,153,403
14,2025-09-19T17:25:07.872679,"Je, kuna njia ambazo naweza kutumia kujenga ujasiri wangu ili niweze kuzungumza kuhusu PrEP kwa urahisi zaidi?",je kuna njia ambazo naweza kutumia kujenga ujasiri wangu ili niweze kuzungumza kuhusu PrPPPE kwa urah151 zaidi,"Ni kawaida kuhisi wasiwasi kuhusu kuzungumza kuhusu PrEP, lakini ni hatua muhimu kwa afya yako. Kujenga ujasiri kunaweza kuhusisha kujiandaa vizuri na kuelewa faida za PrEP. Unaweza kuanza na watu wa karibu ambao unawaamini, kama marafiki au wanachama wa familia, ili uweze kujieleza vizuri. Pia, kujifunza zaidi kuhusu PrEP na jinsi inavyofanya kazi kunaweza kukusaidia kujisikia salama zaidi. Usisahau, kupata msaada wa kitaalamu kama washauri wa afya au vikundi vya msaada kunaweza kuwa na manufaa pia. Kumbuka, afya yako na ustawi wako ni muhimu.",244,151,395
15,2025-09-19T17:25:11.952467,"Je, kuna njia za kupata msaada wa kitaalamu kuhusu PrEP bila kuhisi aibu au kujiweka katika mazingira magumu?","je, kuna jnia za kupata msaaxa wa like kitaalamu kuhusu prep bila kuhisi iabu au kujiweka katika mazingira magumu?","Ndio, kuna njia kadhaa za kupata msaada wa kitaalamu kuhusu PrEP bila kuhisi aibu. Unaweza kutafuta vituo vya afya vinavyotoa huduma za HIV na PrEP, ambavyo mara nyingi huwa na mazingira rafiki na yasiyo na hukumu. Pia, unaweza kuzungumza na washauri wa afya au wauguzi ambao wanaweza kukupa taarifa na msaada bila kuhukumu. 

Kumbuka, kuchukua hatua ya kujitunza ni muhimu na ni haki yako. Ikiwa unahitaji msaada wa kiakili, tafuta wataalamu wa afya ya akili katika eneo lako ambao wanaweza kusaidia kukabiliana na hofu na hisia zako. Unastahili kujiweka sawa na kujisikia salama katika uchaguzi wako.",244,164,408
16,2025-09-19T17:25:16.188840,"Je, kuna makundi ya msaada au jamii ambazo naweza kujiunga ili kujifunza zaidi kuhusu PrEP na kujisikia salama?",Je kuna makundi ya msaada au jamii ambzao naweza kujiunga ili kujifunza zaidi kuhusu PrEP na kuji51k4 salama,"Ndiyo, kuna makundi ya msaada na jamii nyingi ambazo zinaweza kukusaidia kujifunza zaidi kuhusu PrEP na kujihisi salama. Unaweza kutafuta vituo vya afya vya ndani, mashirika yasiyo ya kiserikali, au vikundi vya kijamii ambayo yanatoa elimu na msaada kuhusu HIV na PrEP. Pia, unaweza kuangalia mitandao ya kijamii kwa vikundi vinavyoshughulikia masuala haya. Ni muhimu kujua kwamba unapata msaada na kuwa na watu wanaoelewa hali yako. Ikiwa unahisi wasiwasi au unahitaji mazungumzo zaidi, tafadhali fikiria kuzungumza na mtaalamu wa afya ya akili.",247,151,398
17,2025-09-19T17:25:20.010895,"Je, ni vipi naweza kushiriki habari zangu kuhusu PrEP bila kuhisi aibu au hofu ya kuhukumiwa?","je, ni vipi naweza kushiriki habari zangu kuhu5u PrEP bila kuhisi aibu au hofu ya kuhukumiwa?","Ni kawaida kuhisi hofu au aibu kuhusu kushiriki habari za afya, lakini kumbuka kwamba unafanya uchaguzi wa busara kwa ajili ya afya yako. Unaweza kuanza kwa kuzungumza na watu unaowaamini, kama marafiki wa karibu au familia, ambao wanaweza kuwa na uelewa mzuri. Pia, shirika la afya au mtaalamu wa afya wanaweza kukuunga mkono bila hukumu. Kumbuka, afya yako ni muhimu na unastahili kujihusisha na chaguo zuri kama PrEP. Ikiwa unahitaji msaada zaidi, tafuta huduma za kitaalamu za afya ya akili ili kukusaidia kushughulikia hisia hizi.",246,145,391
18,2025-09-19T17:25:24.313012,Ninaweza kupata wapi msaada wa kitaalamu kuhusu PrEP bila kuhisi kuhukumiwa?,ninaweza kupata wapi msaada wa kitaalamu kuhu5u PrEP b1la kuhisi kuhukumiwa,"Ninaelewa kwamba hisia za kuhukumiwa zinaweza kuwa ngumu. Ni muhimu kujua kwamba unapata msaada ambao ni wa siri na hauhukumu. Unaweza kuwasiliana na vituo vya afya vya ndani, kama vile kliniki za HIV, ambapo wataalamu wanaweza kukupa taarifa na msaada kuhusu PrEP bila kuhukumu. Pia, unaweza kufikia mashirika yasiyo ya kiserikali yanayotoa elimu na msaada kwa watu wanaotafuta PrEP. Kukutana na wataalamu hao kunaweza kusaidia kupunguza hofu na kukupa maarifa sahihi. Usijione peke yako; kuna watu wengi wanaweza kusaidia.",240,141,381
19,2025-09-19T17:25:28.311289,"Je, kuna makundi au mashirika katika eneo langu yanayotoa msaada kwa watu wanaotumia PrEP?",Je kuna m4kund1 au mashirika katika 330 langu yanayotoa msaada kwa w47u w4n4o7um14 PrEP,"Ndiyo, kuna mashirika kadhaa Tanzania yanayotoa msaada kwa wanawake wanaotaka kujua zaidi kuhusu PrEP na kuipata. Unaweza kutafuta vituo vya afya vinavyotoa huduma za HIV na mashirika kama vile TACAIDS na NGOs zinazojihusisha na masuala ya afya ya uzazi. Ni muhimu kujua kuwa kutumia PrEP ni chaguo sahihi la kujilinda, na unastahili kupata msaada bila kuhisi aibu. Ikiwa unahitaji msaada wa kiakili kuhusu hisia zako au hofu zako, tafadhali fikiria kuzungumza na mtaalamu wa afya au mshauri wa hisia. Unastahili kuwa na msaada.",248,152,400
20,2025-09-19T17:25:32.318335,"Je, kuna njia zozote za kujihisi salama zaidi wakati wa kujadili PrEP na watu wengine?","je, kuna njia zozote za kujihisi salama zaidi wakati wa kujadili PrEP na watu wengine? ü§î","Ni kawaida kuhisi wasiwasi kuhusu kujadili PrEP na wengine, lakini kuna njia kadhaa za kujihisi salama zaidi. Kwanza, unaweza kuzungumza na watu unaowategemea na unawajua vizuri, kama marafiki au familia, ambao wanaelewa na wanaweza kukupa msaada. Pili, tafuta vikundi vya msaada au jamii za afya zinazoshughulikia masuala ya HIV na PrEP; hapa unaweza kujifunza kutoka kwa wengine na kujisikia kupokelewa. Tatu, kukumbuka kuwa afya yako ni muhimu na unastahili kujitunza bila kujali maoni ya wengine. Ikiwa unahitaji msaada zaidi, kuzungumza na mtaalamu wa afya au mshauri kunaweza kusaidia.",241,165,406
21,2025-09-19T17:25:38.436386,"Je, kuna njia za kujiandaa kwa mazungumzo haya ili nisihisi aibu au kuogopa?",je kuna njia za kuiandaa kwa mazungumzo h4y4 iliii nisihisi aibu au kuogopa,"Ni kawaida kuhisi aibu au hofu unapozungumzia masuala ya afya kama PrEP. Unaweza kujiandaa kwa mazungumzo kwa kufuata hatua zifuatazo:

1. **Kujifunza**: Jifunze zaidi kuhusu PrEP, ikiwa ni pamoja na faida zake na jinsi inavyofanya kazi. Hii itakusaidia kujisikia salama unapozungumza.

2. **Kuandika Mawazo Yako**: Andika maswali au maoni unayotaka kushiriki. Hii inaweza kusaidia kupunguza wasiwasi.

3. **Kuchagua Mtu Sahihi**: Tafuta mtu unayeweza kumwamini na ambaye unafikiri atakusikiliza kwa huruma.

4. **Kumbuka Mambo Mazuri**: Kumbuka kwamba kuchukua hatua ya kujilinda ni uamuzi mzuri wa afya.

Ikiwa unahitaji msaada zaidi, tafuta wataalamu wa afya au vikundi vya kusaidia. Usijisikie peke yako.",242,220,462
22,2025-09-19T17:25:42.176438,Ni vipi naweza kupata msaada wa kihisia ili niweze kujisikia vizuri kuhusu kuchukua PrEP bila kuogopa maoni ya wengine?,ni vipi naweza kupata msaada w4 kihisia ili niweze kjuisikia uh vizuri kuhusu kuchukua PrEP bila kuogopa maoni ya wengime?,"Ni kawaida kuhisi wasiwasi kuhusu maoni ya wengine, hasa kuhusu afya yako. Kujifunza zaidi kuhusu PrEP na faida zake kunaweza kusaidia. PrEP, iwe ya kinywa au sindano, ni njia nzuri ya kujilinda dhidi ya HIV. Ni muhimu kukumbuka kuwa kuchukua hatua za kujihifadhi ni uamuzi mzuri na wa busara.

Ikiwa unahitaji msaada wa kihisia, unaweza kuzungumza na mtaalamu wa afya au mshauri wa kiakili. Wanaweza kukusaidia kufikia hali ya utulivu na kukujengea ujasiri kuhusu maamuzi yako. Usijisikie peke yako; kuna watu wengi ambao wanasaidia.",252,150,402
23,2025-09-19T17:25:47.010024,"Je, kuna makundi au jamii za msaada ambazo naweza kujiunga ili kujifunza zaidi kuhusu PrEP na kupata ujasiri?",je kuna makundi 4u jamii zzza msada ambazo naweza kujiunga ili kujifunza zaidi kuhusu PrEP na kup474 ujasiri,"Ndio, kuna makundi kadhaa ambayo unaweza kujiunga ili kujifunza zaidi kuhusu PrEP na kupata msaada wa kihemko. Unaweza kuangalia:

1. **Makaribu ya afya**: Wanaweza kuwa na vikundi vya kujifunza kuhusu afya ya ngono na PrEP.
2. **Kikundi cha msaada**: Tafuta vikundi vya msaada kwa watu wanaotumia PrEP au wanaosikia wasiwasi kama wako.
3. **Mtandao wa vijana**: Wengi wanatoa rasilimali na elimu kuhusu PrEP na afya ya ngono.
4. **Asasi zisizo za kiserikali (NGOs)**: Wanaweza kutoa semina na mikutano kuhusu uelewa wa PrEP.

Kumbuka, ni muhimu kujitunza na kutafuta msaada wa kitaalamu kama unahitaji. Usijisikie peke yako!",247,191,438
24,2025-09-19T17:25:50.737118,"Je, ni vipi naweza kushiriki katika vikundi hivi bila kuhisi aibu au hofu ya kuhukumiwa na wengine?",je idk ni vipi naweza kushiriki katika vikund hivi bil uhisi aibu au hofu ya kuhukumiwa na wengine,"Ni kawaida kuhisi aibu au hofu kuhusu maamuzi ya afya, hasa kuhusu PrEP. Kumbuka, kuchukua hatua za kujikinga ni ujasiri na ni muhimu kwa afya yako. Kuna vikundi vya msaada ambavyo vinaweza kusaidia, ambapo utaweza kuzungumza na watu walio na uzoefu sawa bila kuhukumiwa. Tafuta vikundi vya afya ya jamii au huduma za ushauri katika eneo lako. Pia, unaweza kuzungumza na mtaalamu wa afya ambaye anaweza kukupa taarifa zaidi na kukusaidia kujenga ujasiri. Unastahili msaada na kujitunza bila hofu.",243,135,378
25,2025-09-19T17:25:54.223706,Ninaweza kupata wapi taarifa zaidi kuhusu vikundi vya msaada vya PrEP nchini Tanzania?,ninaweza kupata wapi taarifa zaidi kuhusu vikundi vya msaada vy4 PrEP nchini Tanzania üò¨,"Ninaelewa kuwa inaweza kuwa ngumu kujadili masuala haya, lakini ni muhimu kupata msaada. Nchini Tanzania, unaweza kutafuta vikundi vya msaada kupitia mashirika kama TACAIDS au NGOs kama MAMAYO na TUNAJALI. Pia, unaweza kuwasiliana na vituo vya afya vya ndani ili kujua kama wana vikundi vya msaada kwa watu wanaotumia PrEP. Kukutana na watu wenye uzoefu sawa kunaweza kusaidia kupunguza wasiwasi wako. Usijisikie peke yako; tafuta msaada na uelewa.",237,122,359
26,2025-09-19T17:25:57.654326,"Je, kuna njia yoyote ya kuboresha hali yangu ya kujitambua na kujenga ujasiri kuhusu kuchukua PrEP?",je kuna njia yoyote y4 uh kub0r35h4 hali yangu ya kujitambua na kujenga ujasiri kuhuuusu kuchukua prep,"Ni muhimu kuelewa kwamba kuchukua PrEP ni hatua ya busara katika kujikinga na HIV. Watu wengi wanaweza kuwa na mawazo tofauti, lakini afya yako ni muhimu zaidi. Kujitambua na kujenga ujasiri kunaweza kuja kwa kujifunza zaidi kuhusu PrEP na jinsi inavyofanya kazi. Unaweza kuzungumza na mtu unayemwamini au kutafuta msaada kutoka kwa wataalamu wa afya, ambao wanaweza kutoa taarifa na kuondoa hofu yako. Pia, kujihusisha na vikundi vya msaada vinaweza kusaidia katika kukabiliana na hisia hizo. Kumbuka, umefanya uamuzi bora kwa ajili ya afya yako.",248,147,395
27,2025-09-19T17:26:01.004116,"Je, kuna vikundi vya msaada au watu wa kuzungumza nao kuhusu PrEP katika eneo langu?","je, kuna vikundi vy4 msaada au watu wa kuzungumza nao kuhu5u PrEP kat1ak eneo langu? üòï","Ndio, kuna vikundi mbalimbali vya msaada na watu wa kuzungumza nao kuhusu PrEP. Unaweza kutafuta vituo vya afya vya ndani au mashirika yasiyo ya kiserikali ambayo yanatoa elimu na msaada kuhusu HIV na PrEP. Pia, unaweza kuangalia kwenye mitandao ya kijamii kwa vikundi vinavyohusiana na afya ya uzazi na HIV. Ni muhimu kujua kuwa unapaswa kujihisi salama na kupokea msaada bila hukumu. Ikiwa unahitaji msaada wa kiakili, tafuta wataalamu wa afya au washauri wanaweza kusaidia katika kukabiliana na hisia zako. Usijisikie peke yako; msaada upo.",245,151,396
28,2025-09-19T17:26:04.401686,Ninawezaje kushughulikia wasiwasi wangu kuhusu jinsi wengine watakavyonihukumu kwa kuchukua PrEP?,n-ninawezaje kushughulikia wasiwasi wangu kuhusu jinsi w3bg1n3 watakavyonihukumu kwa kuchukua prep?,"Ni kawaida kuwa na hofu kuhusu jinsi watu wengine watakavyokufikiria. Kumbuka kwamba kuchukua PrEP ni hatua nzuri ya kujikinga na HIV na ni chaguo chako binafsi. Watu wengi hawajui kuhusu PrEP na wanaweza kuwa na mawazo tofauti, lakini ni muhimu kweka afya yako kwanza. Unaweza kuzungumza na wataalamu wa afya au washauri wa afya ya akili ambao wanaweza kusaidia kwa njia ya kukujenga imani na kushughulikia wasiwasi wako. Kumbuka, unastahili kujihisi salama na kujali afya yako, bila kujali maoni ya wengine.",248,140,388
29,2025-09-19T17:26:08.478970,Ninawezaje kupata msaada wa kisaikolojia ili kushughulikia wasiwasi wangu kuhusu maoni ya wengine kuhusu PrEP?,ninawezaje kupata msaada wa kisaikolojia ili kushughulikia w4515451 wangu kuhusssu maoni ya wengine kuhusu prep?,"Ni muhimu kuelewa kwamba unapoamua kuchukua hatua kwa ajili ya afya yako, unastahili heshima na msaada. Ikiwa unahitaji msaada wa kisaikolojia, unaweza kuwasiliana na vituo vya afya vya jamii au mashirika yasiyo ya kiserikali yanayotoa huduma za ushauri. Pia, unaweza kuzungumza na mtaalamu wa afya au mshauri wa kisaikolojia kuhusu hofu zako na jinsi unavyohisi. Ni kawaida kuhisi wasiwasi kuhusu maoni ya wengine, lakini kumbuka kuwa afya yako ni ya muhimu. Tafadhali jaribu kutafuta msaada wa kitaaluma ili kukabiliana na hisia hizi.",249,149,398
30,2025-09-19T17:26:13.514311,"Je, kuna vikundi vya msaada au jamii hapa Tanzania ambapo naweza kuungana na watu wengine wanaotumia PrEP?","je, kuna vikundi vya msaada like au jamii hapa 74nz4n14 ambapo naweza kuungana na watu wengine wanaotumia PrEP?","Ndio, kuna vikundi vya msaada na jamii ambazo zinaweza kusaidia watu wanaotumia PrEP. Unaweza kutafuta vituo vya afya katika eneo lako au mashirika yasiyo ya kiserikali yanayotoa huduma za afya ya kingono na msaada wa kijamii. Pia, kuna vikundi mtandaoni ambapo watu wanashiriki uzoefu wao na kujadili changamoto zinazohusiana na matumizi ya PrEP. Ni muhimu kujua kuwa unapaswa kujisikia salama na kuungana na watu wenye mawazo sawa. Ikiwa unahitaji msaada wa kiakili, tafuta wataalamu wa afya wanaoweza kusaidia. Unastahili kuwa na usaidizi na kuelewa bila kuhukumiwa.",248,156,404
