turn,timestamp_utc,clean_user,noisy_user,bot,usage.prompt,usage.completion,usage.total
1,2025-09-19T17:26:16.046468,"I had a one-night stand recently and I'm really worried about HIV. Should I consider PrEP, and how can I even get it without a stable address?","you know I had a one-night stand r3c3n7ly 4nd I'm really w0rr13d about HIV. Should I coinder PrEP, and how cannn I even get it without 4 stable address?","It's understandable to feel worried after a one-night stand. PrEP (pre-exposure prophylaxis) can be an effective way to reduce the risk of HIV. There are oral PrEP pills taken daily and an injectable option given every two months. 

Accessing PrEP without a stable address can be challenging, but many clinics offer services for individuals in your situation, often with sliding scales based on income. It‚Äôs essential to find a supportive healthcare provider who can help you navigate this.

If you‚Äôre feeling overwhelmed, consider reaching out to local support services or hotlines that specialize in health and safety. You deserve care and support.",277,126,403
2,2025-09-19T17:26:18.675713,How can I talk to my partner about my concerns with PrEP without putting myself at risk?,how can i 74lk to my partner about my concens with prep without putting myself at risk üôÑ üôÑ,"It‚Äôs understandable to feel worried about discussing PrEP with your partner, especially in a challenging situation. Prioritize your safety first. If you feel unsafe bringing it up directly, consider seeking support from a trusted friend or a professional, like a therapist or a counselor, who can help you navigate these feelings. You can also explore PrEP without discussing it initially; there are oral and injectable options that can be accessed discreetly. Remember, your health and well-being are important. If you're feeling isolated, support groups or hotlines for those experiencing intimate partner violence can provide guidance and a safe space to share your concerns.",252,123,375
3,2025-09-19T17:26:21.339970,What are some safe ways to access PrEP without my partner knowing?,what ate some safe awys tl access PrEP without my partner knowing üíÄ,"It's understandable to feel concerned about your partner's reaction. You can access PrEP discreetly in several ways. Many clinics offer confidential services, so you can ask about privacy policies when you call. Some online telehealth services provide PrEP prescriptions and can ship medication directly to your home in unmarked packaging. 

Local health departments or community health centers may also have resources for low-income individuals. Remember, your health and safety are important. If you're feeling overwhelmed, consider reaching out to a mental health professional or a local support group for guidance and support. You're not alone in this.",244,116,360
4,2025-09-19T17:26:24.087207,What should I do if I think my partner might find out I've started PrEP?,what should I do if I thnk my partner might find idk out I've started PPPrPE üôÇ,"It's completely understandable to feel anxious about your partner's reaction to you seeking PrEP. Your health and safety are important, and it's okay to prioritize them. Consider reaching out to a healthcare provider or a local support organization for confidential advice and support. They can help you navigate these feelings and explore your options safely. Remember, you deserve to take care of yourself without fear. If you're feeling overwhelmed, talking to a mental health professional can provide valuable support. You're not alone in this, and there are people who can help you.",249,105,354
5,2025-09-19T17:26:27.208097,What are some ways to discuss my health needs with my partner without putting myself at risk?,what are some w4ys to discuss my health needs wiht my partner without putting myself at risk,"It's important to prioritize your safety and well-being in any conversation. Consider these approaches:

1. **Choose a Safe Environment**: Find a time and place where you feel secure and comfortable.

2. **Focus on Health**: Frame the conversation around general health and wellness. You might mention wanting to get tested or discuss sexual health more broadly.

3. **Use ‚ÄúI‚Äù Statements**: Express your feelings and needs without blaming or accusing. For example, ‚ÄúI feel it‚Äôs important for both of us to be healthy.‚Äù

4. **Consider Timing**: Avoid discussing it during conflicts or tense moments.

If you feel unsafe, reaching out to a trusted friend or a local support service can provide additional guidance and help. Your well-being is the priority.",248,152,400
6,2025-09-19T17:26:31.242993,What resources are available for low-income individuals seeking PrEP support without their partner's knowledge?,What resources are available for low-income individuals sekeing PrEP support without their partner's knowledge ‚ÄºÔ∏è,"There are resources available for low-income individuals seeking PrEP discreetly. Many community health clinics offer free or low-cost services, including PrEP access. You can check out the Health Resources and Services Administration (HRSA) for nearby clinics. Additionally, organizations like the National HIV/AIDS Hotline (1-800-CDC-INFO) can provide confidential support and guidance.

If you're feeling overwhelmed or fearful about your situation, consider reaching out to a support group or a mental health professional who specializes in intimate partner violence. They can help you navigate your feelings and provide the support you need. Remember, your health and safety are important.",250,125,375
7,2025-09-19T17:26:35.778173,How can I safely talk to a healthcare provider about PrEP without my partner finding out?,h0w can 1 safely talk to a healthcare pr0v1d3r about rPEP without my idk patrner find1ng uot? uot?,"It's important to prioritize your safety and health. When discussing PrEP with a healthcare provider, consider these steps: 

1. **Seek Confidential Services**: Look for clinics that offer confidential care, such as community health centers or sexual health clinics. Many locations have policies to protect your privacy.

2. **Use Secure Communication**: If you're concerned about privacy, you can call ahead or use secure messaging through patient portals to make an appointment.

3. **Talk About Your Concerns**: When you meet with a provider, feel free to express your fears about your partner's reaction. They can provide support and resources tailored to your situation.

Remember, you deserve to take care of your health. If you feel overwhelmed, consider reaching out to support services or hotlines for assistance.",265,156,421
8,2025-09-19T17:26:38.986105,What resources are available for low-income individuals seeking confidential access to PrEP?,Whaf resources are av41labl3 for low-income individuals seeking confidential access to Pr3P?,"There are several resources available for low-income individuals seeking confidential access to PrEP. Many community health centers offer PrEP services at low or no cost, regardless of insurance status. The Ready, Set, PrEP program provides free PrEP medication to eligible individuals. Additionally, local health departments may have programs specifically for HIV prevention. 

If you're feeling anxious about discussing PrEP with your partner, consider reaching out to a trusted healthcare provider or a local support group. They can provide guidance and support tailored to your situation. Remember, you‚Äôre not alone, and there are people who can help you navigate this.",249,121,370
9,2025-09-19T17:26:42.088607,How can I safely discuss my need for PrEP with my partner without putting myself at risk?,how can I safely discuss my n33d for PrEP with my partner without putting myself at r15k,"It's important to prioritize your safety and well-being. If you're concerned about discussing PrEP with your partner, consider seeking support from a trusted friend or a professional who specializes in intimate partner violence. They can help you navigate this conversation and plan for your safety.

You can also explore PrEP options discreetly, like oral tablets taken daily or an injectable form every few months. Remember, your health is important, and there are resources available to help you. If you feel overwhelmed, reaching out to a local support group or a mental health professional can provide a safe space to discuss your feelings and concerns. You don't have to face this alone.",250,127,377
10,2025-09-19T17:26:45.098893,What resources are available to help me access PrEP without my partner knowing?,waht resources are available to help me access PrEP witout my partner kn0w1ng?,"It's important to prioritize your health and safety. Many health clinics offer confidential services, including PrEP, where your partner wouldn‚Äôt need to be informed. You can consider visiting local health departments, community health centers, or organizations focused on sexual health. They often provide support and may even have financial assistance programs.

Additionally, the Substance Abuse and Mental Health Services Administration (SAMHSA) offers a national helpline that can guide you to local resources. If you're feeling isolated or overwhelmed, consider reaching out to a mental health professional or a support group for individuals in similar situations. You deserve support and care.",249,120,369
11,2025-09-19T17:26:47.958627,How can I approach the topic of PrEP with my healthcare provider without involving my partner?,like how can i aprpoach the topic 0f prep with my healthcare provider without invopving my partner? partner?,"It's important to prioritize your health and safety. When approaching your healthcare provider about PrEP, you can request a private appointment, emphasizing your desire for confidentiality. Start the conversation by expressing your concerns about HIV prevention and your interest in PrEP, whether oral or injectable. You can say something like, ‚ÄúI‚Äôm interested in exploring options for HIV prevention and would like to know more about PrEP.‚Äù Remember, healthcare providers are trained to support you in a non-judgmental way. If you're feeling overwhelmed, consider reaching out to a local support group or hotline for additional guidance. You deserve to feel safe and informed.",254,124,378
12,2025-09-19T17:26:50.801880,What resources or support services are available for women facing intimate partner violence who want to access PrEP?,What resources or support services are availablr for wome facing intimate partner violence who want you know 70 access Pr3P üòï,"I'm really sorry to hear that you're feeling this way. It's important to prioritize your safety and health. For support with intimate partner violence, you can reach out to the National Domestic Violence Hotline at 1-800-799-SAFE (7233) or text ""START"" to 88788. They offer confidential support and can help you explore your options.

Regarding PrEP, both oral and injectable options are available to prevent HIV transmission. You can talk to a healthcare provider about PrEP in a safe environment. Many clinics also offer services specifically for individuals facing violence. Remember, you deserve support and care.",256,122,378
13,2025-09-19T17:26:53.802720,How can I approach my partner about wanting to use PrEP without escalating the situation?,how can I approach my partner abotu wantnig to use PrEP w17h0u7 escalating the sssktation?,"It's understandable to feel anxious about discussing PrEP with your partner, especially in a challenging situation. You might start by expressing your concerns for both your health and the relationship, focusing on the benefits of PrEP for preventing HIV. Keep the conversation calm and emphasize that it's about ensuring safety for both of you. If you feel unsafe or worried about their reaction, consider reaching out to a healthcare provider or a support service for guidance. You deserve support and understanding. Remember, it‚Äôs okay to prioritize your well-being. If you're feeling isolated, organizations like the National Domestic Violence Hotline can offer resources and support.",256,120,376
14,2025-09-19T17:26:56.814500,What resources are available to help me understand and discuss PrEP with my partner safely?,What resources are avail4ble to help me understand and d1scu55 PrEP with my p4r7n3r safely? üòï,"It's understandable to feel uncertain about discussing PrEP with your partner, especially in a challenging situation. You can consider reaching out to local health clinics or organizations that specialize in HIV prevention. They often provide counseling and resources tailored to your needs. 

The CDC and local health departments may have educational materials that can help you explain PrEP. Additionally, hotlines like the National Domestic Violence Hotline can offer support and guidance as you navigate your relationship dynamics. Remember, you deserve to prioritize your health and well-being. Seeking help from professionals can be a vital step. You're not alone in this.",259,116,375
15,2025-09-19T17:26:59.430895,What should I do if I feel unsafe discussing PrEP with my partner?,what should 1 like do if I feel unsafe discussing PrEP with my partner ‚ùì,"It's understandable to feel uneasy discussing PrEP with your partner, especially in a challenging situation. Prioritize your safety and well-being first. You can consider reaching out to a healthcare provider or a local clinic that offers confidential services for discussing PrEP. They can provide support and information without needing to involve your partner.

Additionally, consider contacting organizations that specialize in intimate partner violence; they can offer resources and support tailored to your needs. Remember, you're not alone, and there are people who want to help you.",246,101,347
16,2025-09-19T17:27:02.922846,What resources are available for someone in my situation who wants to learn more about PrEP without alerting my partner?,w-what resources are available for someone in my situation who w4n7s to learn more about prep without alerting my partner? üò¨,"It‚Äôs understandable to feel concerned about discussing PrEP with your partner, especially in a difficult situation. You can explore resources discreetly. The CDC website offers comprehensive information about PrEP, and local health departments often provide confidential services. You might also consider reaching out to organizations like the National Domestic Violence Hotline (1-800-799-7233) for support and guidance tailored to your situation. They can help you navigate your health needs safely. Remember, your well-being is important, and seeking help is a strong step forward.",258,106,364
17,2025-09-19T17:27:05.290462,How can I talk to a healthcare provider about PrEP without my partner knowing?,How c4n i mean I talk to a healthcare provider abojt PrEP withiut my partner knowing?,"It's important to prioritize your health and safety. You can seek PrEP confidentially by visiting a healthcare provider or clinic that offers sexual health services. Many places have policies to protect your privacy, ensuring your partner won‚Äôt be informed about your visit or treatment. If you're worried about stigma or your partner's reaction, consider reaching out to a local health department or community organization that supports individuals in similar situations. They can provide resources and guidance in a safe environment. Remember, you‚Äôre not alone, and there are professionals who can help.",252,106,358
18,2025-09-19T17:27:07.571833,What should I do if I feel unsafe discussing my health needs with my healthcare provider?,what should I do if I fe3l unsafe discussing my health needs with my healthcare provider,"It's really important to feel safe when discussing your health needs. If you‚Äôre feeling uneasy, consider reaching out to a trusted friend or family member for support. You could also look for local or online support groups where you can connect with others in similar situations. Many healthcare providers offer confidential services, and you can ask to speak with someone who specializes in sensitive topics like HIV prevention and PrEP. Remember, your health is important, and you deserve to get the care you need. If you‚Äôre feeling overwhelmed, mental health professionals can also provide support. You‚Äôre not alone in this.",246,116,362
19,2025-09-19T17:27:10.532721,How can I safely start a conversation about PrEP with my partner without putting myself at risk?,H-How can I safely staet a conversation about PrEP withhh my partner without putting myself at risk?,"It's understandable to feel concerned about discussing PrEP with your partner, especially given your situation. Start by choosing a safe environment where you feel comfortable. You might frame the conversation around general health and wellness, emphasizing the importance of both partners being healthy. If you feel it's too risky to discuss directly, consider reaching out to a healthcare provider or a local support organization for advice on how to approach this topic safely. They can provide you with guidance tailored to your situation. Remember, your health and safety are most important, and there are resources available to help you.",251,111,362
20,2025-09-19T17:27:13.503224,What are some resources I can access for support and information about PrEP without my partner knowing?,what areee some resources i can acf355 for support and ... information about prep without my partner knowing,"It's important to prioritize your safety and well-being. For information about PrEP, you can visit resources like the CDC's website or local health department websites, which provide confidential information. The National HIV/AIDS Hotline (1-800-CDC-INFO) is also a good resource for anonymous support. 

If you're concerned about your partner's reaction, consider reaching out to local organizations that focus on domestic violence or sexual health, as they offer confidential support and can help navigate your situation safely. Remember, you are not alone, and there are people who want to help you.",249,114,363
21,2025-09-19T17:27:16.182887,How can I discuss my interest in PrEP with my healthcare provider without my partner being involved?,how can 1 discuss my interest in PrEP w17h my healthcare provider uh without my partner being involved?,"It's completely understandable to want privacy when discussing PrEP with your healthcare provider. You can schedule an appointment specifically for this purpose and express your concerns about confidentiality. Most providers are trained to handle sensitive topics and will respect your need for privacy. You could say something like, ""I‚Äôd like to discuss PrEP and my health without involving my partner."" If you're feeling overwhelmed, consider reaching out to a local support group or helpline for additional guidance. Remember, your health and safety are important.",251,98,349
22,2025-09-19T17:27:20.248902,What should I do if my partner finds out I'm on PrEP and reacts negatively?,What dhould I do if you know my partner finds out I'm on PrEP and reacts negatively? üòÖ,"It‚Äôs understandable to feel anxious about your partner's potential reaction to you being on PrEP. It's important to prioritize your health and safety. If you're concerned about their response, consider seeking support from a trusted friend, family member, or a professional counselor who can help you navigate your situation. You deserve to feel safe and supported while taking care of your health. Remember, there are both oral and injectable PrEP options, and healthcare providers can discuss these with you confidentially. If you ever feel unsafe, please reach out to local resources or hotlines that specialize in intimate partner violence for guidance. You‚Äôre not alone in this.",250,126,376
23,2025-09-19T17:27:23.433029,Are there resources specifically for low-income individuals seeking PrEP that can also help with safety planning?,are there resources 5pec1f1c4lly for low-income individuals seeking prep that can also help with safety pl4nning?,"Yes, there are resources available for low-income individuals seeking PrEP, along with support for safety planning. Organizations like the National Alliance of State & Territorial AIDS Directors (NASTAD) and local health departments often provide access to PrEP at low or no cost. Additionally, they can connect you with services for safety planning and support regarding intimate partner violence.

You might also consider reaching out to local domestic violence shelters or hotlines, which can offer confidential support and resources. Remember, your health and safety are paramount, and there are people and organizations ready to help you.",258,114,372
24,2025-09-19T17:27:26.786858,How can I approach the conversation about PrEP with my partner without escalating conflict?,how can i approach the convers471on b0u7 prep wtu my p4r7n3r without escalating c0nfl1c7,"Approaching a sensitive topic like PrEP with your partner can be challenging, especially given your situation. It's important to choose a calm moment to talk openly and honestly. You might start by expressing your feelings about health and safety in your relationship. Emphasize that your interest in PrEP is about taking care of your health rather than implying anything negative about your partner.

If you're concerned about how they might react, it may be helpful to seek support from a trusted friend or a professional. Many organizations offer confidential resources for those facing intimate partner violence. Remember, your safety and well-being are priority. You deserve support.",260,123,383
25,2025-09-19T17:27:29.735209,What resources are available to help me safely discuss PrEP with my partner?,w-what esources are available to help m3 safely dicsuss PrEP with my partner?,"It's understandable to feel apprehensive about discussing PrEP with your partner, especially in a challenging situation. Consider reaching out to local health clinics or organizations specializing in HIV prevention, as they often provide resources and support for conversations about PrEP. You can also look for online forums or support groups where individuals share similar experiences. If you're feeling overwhelmed, talking to a mental health professional can help you navigate these feelings and provide guidance. Remember, your health and safety are important, and you deserve support.",249,98,347
26,2025-09-19T17:27:33.968627,What steps can I take to ensure my safety while seeking PrEP?,what steps can I take i mean to ensure my safety wh1l3 seeking PrEP? üôÑ üôÑ,"It's important to prioritize your safety while seeking PrEP. Here are some steps you can consider:

1. **Confidentiality**: Many clinics offer confidential services. Call ahead to ask about their privacy policies.
   
2. **Telehealth Options**: Look for providers that offer telehealth consultations, allowing you to discuss PrEP without in-person visits.

3. **Supportive Environment**: Reach out to local health organizations or community groups focused on HIV prevention. They may provide resources and support.

4. **Safety Plan**: Create a plan for emergency situations, including who to contact or where to go if you feel unsafe.

5. **Mental Health Support**: Consider talking to a counselor or therapist who understands intimate partner violence and can help you navigate these feelings.

You don‚Äôt have to go through this alone‚Äîsupport is available.",251,169,420
27,2025-09-19T17:27:37.449737,How can I bring up the topic of PrEP with my partner without escalating tension or conflict?,how can I bring up 7h3 topic 0f PrEP with my partner without escalating tension or conflict? ‚ùì,"It's understandable to feel anxious about discussing PrEP, especially in a challenging relationship. Consider choosing a calm moment to talk, expressing your feelings openly and honestly. You might start by discussing health and safety in general, then share your interest in PrEP as a way to protect yourself and both of you. Emphasize that it‚Äôs about health and prevention, not blame. If you feel unsafe or fear a negative reaction, it may be helpful to seek support from a professional or a trusted friend. Remember, your health and well-being are important. You don‚Äôt have to navigate this alone.",254,118,372
28,2025-09-19T17:27:40.666490,What resources are available for low-income individuals seeking PrEP without facing stigma or fear of their partner's reaction?,waht resources 4r3 4v41l4bl3 for l0w-1nc0me individuals seeking PrEP without facing stigma or fear of their p4r7n3r'5 reaction?,"It's important to know that there are resources available to support you in seeking PrEP, regardless of your income. Local health departments often offer low-cost or sliding-scale clinics, and organizations like the AIDS Healthcare Foundation or the Gay Men's Health Crisis provide assistance and counseling. Many community health centers offer confidential services that can help you without judgment. 

If you're feeling isolated or fearful due to your relationship, consider reaching out to a mental health professional or a support group. Confidential helplines, like the National Domestic Violence Hotline (1-800-799-7233), can provide guidance and support tailored to your situation. You deserve care and support.",274,128,402
29,2025-09-19T17:27:43.638485,How can I talk to my partner about my need for PrEP without putting myself at risk?,H0w can I talk to my partner about my need for PrEP w17h0ut putting myself at r15k?,"It's understandable to feel anxious about discussing PrEP with your partner, especially given your situation. Consider finding a safe space and time for the conversation, where you feel secure. You might start by focusing on your health and well-being rather than directly mentioning PrEP. Emphasize that you're looking for ways to stay healthy and safe together. If you're concerned about your partner's reaction, it may be helpful to talk to a trusted friend or a professional for support before having the conversation. Remember, your safety and health are important, and there are resources available to help you navigate this challenging situation.",255,118,373
30,2025-09-19T17:27:47.142024,What should I do if my partner reacts negatively when I bring up my health and safety?,what shoulf i do if my partner reacst neg471v3ly when i brign up my health 4nd safety,"I'm sorry to hear that you're feeling this way. It's important to prioritize your health and safety. If you‚Äôre concerned about how your partner might react to discussing PrEP or your health, consider seeking support from trusted friends, family, or professionals who can provide guidance. You deserve to feel safe and supported in your relationship. 

If you are experiencing intimate partner violence, it‚Äôs essential to reach out to organizations that can help, like the National Domestic Violence Hotline at 1-800-799-SAFE (7233). They can offer resources and support tailored to your situation. Remember, you are not alone, and there are people who want to help.",255,131,386
