turn,timestamp_utc,clean_user,noisy_user,bot,usage.prompt,usage.completion,usage.total
1,2025-09-19T17:47:14.120863,y a-t-il d35 ressources sp√©cifiques pour les personnes qui ss remettent d'un traumatisme ?,y a-t-il d35 ressources 5p√©c1f1qu35 pour les personnes qui ss remettent d'un traumatisme traumatisme,"Je comprends que traverser un traumatisme peut √™tre tr√®s difficile. Il existe des ressources pour vous soutenir. En France, vous pouvez contacter des associations comme SOS Suicide ou l'Association Fran√ßaise de Lutte contre le SIDA (AFLS), qui offrent des services d'√©coute et de conseil. 

Pour des conseils sp√©cifiques sur la sant√© mentale, envisager de consulter un professionnel, comme un psychologue ou un psychiatre, peut √™tre b√©n√©fique. Ils sont form√©s pour aider √† g√©rer l'anxi√©t√© et d'autres √©motions difficiles. N'oubliez pas que prendre soin de votre sant√© mentale est tout aussi important que votre sant√© physique.",276,128,404
2,2025-09-19T17:47:19.186885,"Quels sont les effets de la PrEP sur la sant√© mentale, en particulier pour ceux qui souffrent d'anxi√©t√© ?","q-quels sont les effets ce la prep 5ur la i mean sant√© mentale, en p4r71cul13r p0ur ceux qui sooouffrent d'anxi√©t√© ?","Il est compr√©hensible de s'inqui√©ter de l'impact de la PrEP sur la sant√© mentale, surtout en cas d'anxi√©t√©. Les √©tudes sur la PrEP, qu'elle soit orale ou injectable, montrent g√©n√©ralement qu'elle est bien tol√©r√©e et n'aggrave pas l'anxi√©t√© pour la plupart des gens. Cependant, les r√©actions individuelles peuvent varier. Il est important de discuter de ces pr√©occupations avec un professionnel de la sant√© qui peut vous aider √† √©valuer votre situation personnelle. Si vous ressentez le besoin de soutien √©motionnel, n'h√©sitez pas √† contacter un th√©rapeute ou un groupe de soutien. Vous n'√™tes pas seule dans ce parcours.",284,138,422
3,2025-09-19T17:47:22.716858,Quelles sont les ressources disponibles pour obtenir un soutien psychologique lors de la prise de PrEP ?,Quell35 sont idk les ressources disponibles pour obtenir un soutien p5yhcol0g1qu3 lors de la prise de Pr3P ?,"Il existe plusieurs ressources pour obtenir un soutien psychologique lors de la prise de PrEP. Vous pouvez consulter des professionnels de la sant√© mentale, comme des psychologues ou des th√©rapeutes, qui peuvent vous aider √† g√©rer l'anxi√©t√© et les pr√©occupations li√©es √† votre situation personnelle. 

Des organisations locales et nationales, comme AIDES ou le Sidaction en France, offrent √©galement des services d'accompagnement et des groupes de soutien. Ces espaces peuvent vous permettre de partager vos exp√©riences sans jugement. N'h√©sitez pas √† rechercher des ressources qui vous conviennent et √† vous entourer de personnes compr√©hensives.",275,122,397
4,2025-09-19T17:47:25.890440,Comment puis-je trouver un th√©rapeute qui comprend les enjeux li√©s √† la prise de PrEP ?,comment puisj-e trouver un th√©rapeute qui comprend les like ejneux li√©w √† la prise de PErP ? ?,"Pour trouver un th√©rapeute qui comprend les enjeux li√©s √† la prise de PrEP, vous pouvez commencer par consulter des ressources en ligne comme des annuaires de th√©rapeutes ou des plateformes sp√©cialis√©es en sant√© mentale. Il est √©galement utile de chercher des professionnels ayant de l'exp√©rience dans le domaine de la sant√© sexuelle ou du VIH. N'h√©sitez pas √† poser des questions lors de votre premi√®re consultation pour √©valuer leur sensibilit√© √† votre situation. Les associations locales sur la sant√© sexuelle peuvent √©galement offrir des recommandations. Votre bien-√™tre mental est important, et il existe des professionnels pr√™ts √† vous soutenir.",270,118,388
5,2025-09-19T17:47:29.305756,Quels sont les effets secondaires de la PrEP sur la sant√© mentale que je devrais surveiller ?,Qu3l5 sont les effets secondaires de la PrEP sur la sant√© mentale que je dvrais surrrveiller ? ?,"La PrEP, qu'elle soit orale ou injectable, est g√©n√©ralement bien tol√©r√©e, mais les effets secondaires peuvent varier d'une personne √† l'autre. Concernant la sant√© mentale, certaines personnes signalent une augmentation de l'anxi√©t√© ou des pr√©occupations li√©es √† la prise de m√©dicaments. Il est essentiel de rester √† l'√©coute de vos √©motions et de votre √©tat d'esprit. Si vous ressentez des changements pr√©occupants, n'h√©sitez pas √† en parler √† un professionnel de la sant√© qui pourra vous soutenir. Vous n'√™tes pas seule dans ce parcours, et il existe des ressources pour vous accompagner.",270,122,392
6,2025-09-19T17:47:32.879803,Comment puis-je trouver un professionnel de la sant√© qui comprend mes pr√©occupations li√©es √† la PrEP et √† ma sant√© mentale ?,comment puis-je trouver un professionnel d3 la sant√© qui c0mpr3nd mes pr√©occupations li√©es √† la PrEP et √† ma ant√© mentale ?,"Il est important de trouver un professionnel de la sant√© qui puisse √©couter vos pr√©occupations avec empathie. Vous pouvez commencer par demander √† votre m√©decin g√©n√©raliste une recommandation vers un sp√©cialiste en sant√© mentale ou en sant√© sexuelle. Les centres de sant√© communautaire ou des cliniques sp√©cialis√©es dans le VIH peuvent √©galement offrir des services adapt√©s et compr√©hensifs. N‚Äôh√©sitez pas √† poser des questions sur leur approche pour vous assurer qu'ils comprennent vos pr√©occupations. Si vous ressentez le besoin de parler √† quelqu'un, des lignes d'√©coute ou des groupes de soutien peuvent √©galement √™tre de bonnes ressources. Vous m√©ritez un soutien qui respecte votre v√©cu.",275,131,406
7,2025-09-19T17:47:36.964454,Quels sont les effets secondaires de la PrEP sur la sant√© mentale que je devrais surveiller ?,quels wont les effets secondaires de la prep sur la snt√© mentale que je devrais surveiller,"La PrEP, qu'elle soit orale ou injectable, est g√©n√©ralement bien tol√©r√©e, mais certaines personnes peuvent ressentir des effets secondaires. Concernant la sant√© mentale, il n'y a pas d'effets secondaires sp√©cifiques directement li√©s √† la PrEP, mais les inqui√©tudes et le stress li√©s √† son utilisation peuvent parfois aggraver l'anxi√©t√© ou la d√©pression chez certaines personnes.

Il est important d‚Äô√™tre √† l‚Äô√©coute de soi-m√™me et de discuter de vos pr√©occupations avec un professionnel de sant√©. Ils peuvent vous aider √† √©valuer votre situation personnelle dans un cadre s√ªr et non jugeant. N'h√©sitez pas √† demander du soutien si vous en ressentez le besoin.",265,137,402
8,2025-09-19T17:47:40.872029,Comment puis-je trouver un professionnel de sant√© compr√©hensif pour discuter de mes pr√©occupations concernant la PrEP et ma sant√© mentale ?,c-comment puis-je trouver un professionnel dd sant√© compr√©hensif our discuter de m35 like pr√©occupations concernant la prep et ma sant√© mentale ?,"Pour trouver un professionnel de sant√© compr√©hensif, vous pouvez commencer par demander des recommandations √† des amis de confiance ou √† des membres de votre famille. Les associations locales de sant√© sexuelle peuvent √©galement vous orienter vers des sp√©cialistes sensibles aux questions de sant√© mentale et de pr√©vention du VIH. 

N'h√©sitez pas √† chercher des centres de sant√© communautaires qui offrent des services de PrEP, car ils ont souvent des √©quipes form√©es pour aborder ces pr√©occupations. Vous pouvez √©galement consulter des lignes d'√©coute ou des services de sant√© mentale qui peuvent vous soutenir dans cette d√©marche. Votre bien-√™tre est important et vous m√©ritez de recevoir des soins adapt√©s.",273,129,402
9,2025-09-19T17:47:44.290011,Y a-t-il des effets secondaires de la PrEP qui pourraient affecter mon anxi√©t√© ou ma sant√© mentale ?,y a-t-il des effets secondddaires de la PrEP qui pourraient affecter mon anxi√©t√© ou ma 54n7√© mentale ü´†,"La PrEP, qu'elle soit orale ou injectable, peut avoir des effets secondaires, mais ceux-ci varient d'une personne √† l'autre. Certains utilisateurs rapportent des effets comme des naus√©es ou des maux de t√™te, mais il est moins courant qu'elle affecte directement la sant√© mentale ou l'anxi√©t√©. Il est essentiel d'en discuter avec un professionnel de la sant√© qui peut vous fournir des informations adapt√©es √† votre situation personnelle. Si vous ressentez de l'anxi√©t√© ou des pr√©occupations li√©es √† la stigmatisation, envisagez de parler √† un th√©rapeute ou √† un conseiller qui peut vous offrir un soutien adapt√©. Vous m√©ritez de vous sentir bien et en s√©curit√© dans vos choix.",276,145,421
10,2025-09-19T17:47:48.007452,Quels conseils pourriez-vous me donner pour g√©rer mon anxi√©t√© tout en prenant la PrEP ?,w-wuels c0ns31ls p0urr13z-vou5 uh me d0nn3r pour g√©rer mon 4nxi√©t√© tout 3n prenant laaa PrEP ‚ÄºÔ∏è ‚ÄºÔ∏è,"Il est tout √† fait normal de s'inqui√©ter de l'impact de la PrEP sur votre sant√© mentale, surtout apr√®s un traumatisme. La PrEP, qu'elle soit orale ou injectable, est g√©n√©ralement bien tol√©r√©e, mais il est important de parler de vos pr√©occupations avec un professionnel de la sant√© qui peut vous offrir un soutien personnalis√©. 

Pour g√©rer votre anxi√©t√©, envisagez de consulter un th√©rapeute ou un conseiller, qui peut vous aider √† explorer vos sentiments et √† d√©velopper des strat√©gies d'adaptation. Plusieurs ressources, comme des lignes d'√©coute ou des groupes de soutien, peuvent √©galement vous apporter du r√©confort. Vous n'√™tes pas seule dans cette d√©marche.",290,141,431
11,2025-09-19T17:47:51.626419,Comment puis-je trouver un professionnel de sant√© qui comprend mes pr√©occupations concernant la PrEP et son impact sur ma sant√© mentale ?,comment pis-je trouver un professionnel d3 sant√© qui comprend mes pr√©occupations concernant la prep et son impact sur ma sang√© m3nt77al3,"Pour trouver un professionnel de sant√© qui comprend vos pr√©occupations, vous pouvez commencer par :

1. **Chercher des cliniques sp√©cialis√©es** : Recherchez des centres de sant√© communautaires ou des cliniques sp√©cialis√©es en sant√© sexuelle qui offrent des services li√©s √† la PrEP.

2. **Consulter des associations locales** : Des organisations comme AIDES ou d'autres groupes de soutien peuvent vous orienter vers des professionnels empathiques et inform√©s.

3. **Demander des recommandations** : Parlez √† des amis de confiance ou √† des groupes de soutien en ligne pour obtenir des recommandations.

N‚Äôh√©sitez pas √† poser des questions sur leur approche en mati√®re de sant√© mentale lors de votre premier rendez-vous. C'est important de vous sentir √† l‚Äôaise.",274,155,429
12,2025-09-19T17:47:55.228931,Quelles sont les alternatives √† la PrEP si je suis pr√©occup√©e par son impact potentiel sur mon anxi√©t√© ?,quelles sont les alternatives √† la PrEP si je suis rp√©oooccup√©e par son 1mp4ct potenitel sur monnn 4nxi√©7√© ?,"Il existe plusieurs alternatives √† la PrEP si vous avez des pr√©occupations concernant son impact sur votre anxi√©t√©. Vous pourriez envisager des m√©thodes de pr√©vention comme les pr√©servatifs, qui sont efficaces pour r√©duire le risque de transmission du VIH. Rencontrer un professionnel de la sant√© mentale pourrait √©galement vous aider √† aborder vos pr√©occupations concernant l'anxi√©t√©. Ils peuvent vous donner des outils pour g√©rer votre sant√© mentale tout en explorant vos options de pr√©vention. N'h√©sitez pas √† chercher des ressources locales pour le soutien psychologique et la sant√© sexuelle. Votre bien-√™tre est important et il existe des solutions adapt√©es √† votre situation.",282,127,409
13,2025-09-19T17:47:59.088030,Comment puis-je aborder mes pr√©occupations concernant la stigmatisation li√©e √† la PrEP avec un professionnel de la sant√© ?,comment puis-je 4b0rd3r mes pr√©occupations cn0c3rn4nt oa stigmatisation li√©e √† la like prep avec un professionnel de la 54n7√©,"Il est tout √† fait normal de ressentir des pr√©occupations concernant la stigmatisation li√©e √† la PrEP. Pour aborder ces sentiments, envisagez de consulter un professionnel de la sant√©, comme un m√©decin ou un conseiller en sant√© mentale, qui peut vous offrir un espace s√ªr pour discuter de vos craintes. Ils peuvent √©galement vous fournir des informations sur la PrEP et son impact potentiel sur votre sant√© mentale. N'h√©sitez pas √† partager vos pr√©occupations avec eux, car ils sont l√† pour vous soutenir. Si vous ressentez le besoin de parler √† quelqu'un, des ressources comme SOS Suicide ou des lignes d'√©coute peuvent √©galement √™tre utiles.",283,131,414
14,2025-09-19T17:48:03.604284,Quelles sont les options pour obtenir de la PrEP tout en √©tant pr√©occup√©e par ma sant√© mentale ?,quelles sont les options pour obtenir de la PrP tout en um √©74n7 pr√©occup√©e ;ar ma sant√© mentale ? ?,"Il est compr√©hensible de s'inqui√©ter de l'impact potentiel de la PrEP sur votre sant√© mentale, surtout apr√®s un traumatisme. La PrEP est disponible sous forme orale (tablettes √† prendre quotidiennement) et injectable (injections tous les deux mois). Avant de commencer, il est important de discuter de vos pr√©occupations avec un professionnel de sant√© qui peut vous soutenir et vous offrir des conseils adapt√©s √† votre situation. 

Si vous ressentez de l'anxi√©t√©, envisagez √©galement de parler √† un th√©rapeute ou un conseiller qui peut vous aider √† naviguer dans ces √©motions. Vous n'√™tes pas seule, et il existe des ressources pour vous soutenir.",271,140,411
15,2025-09-19T17:48:08.173059,Quelles sont les ressources disponibles pour m'aider √† g√©rer mon anxi√©t√© pendant que je pense √† commencer la PrEP ?,quelles sont les ressources disponibles pour m'aider √† g√©rer kon anxi√©t√© pendant que j3 pense √† commencer la PrEP you know ? üòï,"Il est tout √† fait normal de ressentir de l'anxi√©t√© lorsque l'on envisage de commencer la PrEP. Pour vous soutenir, vous pouvez envisager de consulter un professionnel de la sant√© mentale, comme un psychologue ou un conseiller, qui peut vous aider √† aborder vos pr√©occupations. 

Il existe √©galement des lignes d'√©coute et des groupes de soutien o√π vous pouvez partager vos exp√©riences et recevoir des conseils. Des organisations comme AIDES en France offrent des ressources et un soutien pour les personnes pr√©occup√©es par le VIH et la PrEP. N'oubliez pas que vous n'√™tes pas seule dans cette d√©marche et que des solutions existent pour vous aider √† vous sentir mieux.",274,137,411
16,2025-09-19T17:48:11.277593,Comment puis-je trouver des professionnels de sant√© qui comprennent mes pr√©occupations concernant la PrEP et la sant√© mentale ?,c0mm3n7 puis-je trouver des professionnels de sant√© qui like comprennent mes pr√©occupations concernant la prep et la sant√© mmmentale,"Il est important de parler √† des professionnels qui comprennent vos pr√©occupations. Vous pouvez consulter des m√©decins sp√©cialis√©s en sant√© sexuelle, des psychologues ou des conseillers sp√©cialis√©s dans le VIH et la sant√© mentale. Les centres de sant√© communautaires ou les cliniques sp√©cialis√©es en pr√©vention du VIH offrent souvent des services de soutien et des conseils. 

N‚Äôh√©sitez pas √† demander des r√©f√©rences ou √† rechercher des groupes de soutien en ligne o√π vous pouvez √©changer vos exp√©riences. Votre sant√© mentale est tout aussi importante que votre sant√© physique, et il existe des ressources pour vous accompagner.",272,113,385
17,2025-09-19T17:48:14.307841,Y a-t-il des ressources ou des groupes de soutien en ligne qui se concentrent sur la sant√© mentale des personnes prenant la PrEP ?,y a-t-il des ressources ou desss groupes de soutien en ligne qui se concentrent sur la sant√© mentale des personnes prenant la prep ? ?,"Oui, il existe plusieurs ressources et groupes de soutien en ligne pour les personnes prenant la PrEP et pr√©occup√©es par leur sant√© mentale. Des organisations comme AIDES en France offrent des informations et des conseils. Vous pouvez √©galement explorer des forums et des groupes sur des plateformes comme Facebook ou Reddit, o√π les gens partagent leurs exp√©riences. 

N'h√©sitez pas √† consulter un professionnel de la sant√© mentale pour aborder vos pr√©occupations sp√©cifiques. Votre bien-√™tre est important, et il existe des personnes pr√™tes √† vous soutenir.",273,103,376
18,2025-09-19T17:48:18.509276,Quels sont les effets secondaires de la PrEP qui pourraient influencer mon √©tat d'esprit et mon anxi√©t√© ?,Quels osnt les effets secondaiers d3 la PrEP qui pourraient influencer mon √©tat d'esprit et mon anxi√©t√© ? ?,"La PrEP, qu'elle soit orale ou injectable, peut avoir des effets secondaires, mais ils varient d'une personne √† l'autre. Les effets secondaires courants comprennent des naus√©es, des maux de t√™te ou des douleurs abdominales, mais beaucoup de gens ne ressentent aucun effet ind√©sirable significatif. Certaines personnes peuvent √©galement √©prouver de l'anxi√©t√© li√©e √† la prise d'un m√©dicament, surtout si elles sont pr√©occup√©es par le jugement des autres. Il est important de discuter de vos inqui√©tudes avec un professionnel de sant√© qui pourra vous soutenir et vous aider √† prendre une d√©cision √©clair√©e. N'h√©sitez pas √† chercher des ressources en sant√© mentale si vous ressentez le besoin d'un soutien suppl√©mentaire.",271,146,417
19,2025-09-19T17:48:23.118225,Comment puis-je trouver un professionnel de sant√© qui comprend mes pr√©occupations sur la PrEP et la sant√© mentale ?,comment pu15-j3 trouver un prof35510nn3l de idk saaant√© qui comprend mes pr√©occupations shr la PrEP et la 54n7√© mentzle ?,"Il est important de trouver un professionnel de la sant√© qui soit √† l'√©coute de vos pr√©occupations. Vous pouvez commencer par consulter un m√©decin g√©n√©raliste qui a de l'exp√©rience avec la PrEP et les questions de sant√© mentale. Recherchez des cliniques sp√©cialis√©es dans les IST ou la sant√© sexuelle, car elles offrent souvent des services de conseil. Les organisations locales ou nationales de lutte contre le VIH peuvent √©galement vous orienter vers des ressources et des professionnels form√©s. N'h√©sitez pas √† poser des questions sur leurs exp√©riences avec d'autres patients ayant des pr√©occupations similaires. Prenez soin de vous et sachez que vous n'√™tes pas seule dans ce processus.",283,134,417
20,2025-09-19T17:48:27.535768,Quels sont les effets secondaires de la PrEP sur la sant√© mentale auxquels je devrais √™tre attentive ?,Quels sont les evfetsss secondaires de la PrEP syr la sant√© mentale auxquels je devrais √™trs attentive,"Il est compr√©hensible d'√™tre pr√©occup√©e par l'impact de la PrEP sur votre sant√© mentale, surtout dans le cadre de votre r√©tablissement. Les effets secondaires de la PrEP, qu'elle soit orale ou injectable, varient d'une personne √† l'autre. Certains utilisateurs ont signal√© des changements d'humeur ou une augmentation de l'anxi√©t√©, mais cela n'est pas syst√©matique. Il est essentiel de discuter de vos pr√©occupations avec un professionnel de sant√© qui peut vous fournir des conseils adapt√©s √† votre situation. Si vous ressentez un besoin de soutien √©motionnel, envisagez de parler avec un th√©rapeute ou un conseiller. Vous m√©ritez de vous sentir bien et soutenue dans votre d√©cision.",266,146,412
21,2025-09-19T17:48:31.654813,Comment puis-je parler de mes inqui√©tudes concernant la PrEP √† mon m√©decin sans craindre d'√™tre jug√©e ?,comment puis-je parler de mes inqui√©tudes concernant la PrEP √† mon m√©decin aans cranidre d'√™tre jug√©e ü´†,"C‚Äôest tout √† fait normal d‚Äôavoir des pr√©occupations, et il est important de les partager avec votre m√©decin. Vous pourriez commencer par dire que vous avez des questions sur la PrEP et que vous √™tes pr√©occup√©e par son impact sur votre sant√© mentale, surtout dans le cadre de votre situation personnelle. Rappelez-vous que les m√©decins sont l√† pour vous soutenir sans jugement. Vous pouvez √©galement demander des ressources pour la sant√© mentale si cela vous aide √† vous sentir plus √† l‚Äôaise. N‚Äôh√©sitez pas √† exprimer vos craintes concernant la stigmatisation ; cela pourrait ouvrir un dialogue constructif. Vous m√©ritez d‚Äô√™tre entendue et soutenue.",270,133,403
22,2025-09-19T17:48:37.094419,Y a-t-il des moyens de r√©duire l'anxi√©t√© li√©e √† la prise de PrEP tout en restant prot√©g√©e contre le VIH ?,y a-t-il idk des moyens de r√©duire l'anxi√©t√© li√©e √† la prise de PrEP tout en restant prot√©g√©e contre le VIHHH ? üíÄ üíÄ,"Il est compr√©hensible d'avoir des inqui√©tudes concernant l'anxi√©t√© li√©e √† la prise de PrEP. Vous pouvez envisager plusieurs approches pour r√©duire cette anxi√©t√©, comme parler √† un professionnel de la sant√© qui peut vous aider √† comprendre la PrEP et ses effets. Le soutien de proches ou de groupes de soutien peut √©galement √™tre b√©n√©fique. 

Rappelez-vous que la PrEP, qu'elle soit orale ou injectable, est efficace pour r√©duire le risque de transmission du VIH. Si vous ressentez des pr√©occupations persistantes, il peut √™tre utile de consulter un professionnel de la sant√© mentale. Ils peuvent vous offrir un soutien adapt√© √† votre situation. Vous n'√™tes pas seule dans ce processus.",280,146,426
23,2025-09-19T17:48:42.205359,Quels sont les effets secondaires possibles de la PrEP qui pourraient influencer mon √©tat d'anxi√©t√© ?,quels sont les effets idk secodaires possibles de l4 PrEP qui pourrzient influencer mon √©tat d'anxi√©t√© ?,"La PrEP, qu'elle soit orale ou injectable, peut avoir des effets secondaires, bien que beaucoup de personnes ne ressentent aucun probl√®me. Les effets secondaires courants incluent des naus√©es, des maux de t√™te ou des douleurs abdominales, qui sont g√©n√©ralement temporaires. Certaines personnes peuvent √©galement ressentir de l'anxi√©t√© ou des pr√©occupations li√©es √† leur traitement. 

Il est important de discuter de vos pr√©occupations avec un professionnel de sant√©, qui pourra vous offrir un soutien adapt√© √† votre situation. Si vous ressentez une augmentation de votre anxi√©t√©, envisager de parler avec un th√©rapeute ou un conseiller pourrait √™tre b√©n√©fique. Prenez soin de vous et sachez que vous n'√™tes pas seule.",272,149,421
24,2025-09-19T17:48:46.041484,Comment puis-je trouver un professionnel de sant√© compr√©hensif pour discuter de mes pr√©occupations concernant la PrEP et mon anxi√©t√© ?,comment puis-je trouver uh un professionnel de sant√©√©√© compr√©hensif pour discuter de mes pr√©occupations concernant la prep 37 mon anxi√©t√©,"Il est important de trouver un professionnel de sant√© avec qui vous vous sentez √† l'aise. Vous pouvez commencer par demander des recommandations √† des amis ou √† des groupes de soutien locaux. Les centres de sant√© communautaires ou les cliniques sp√©cialis√©es en sant√© sexuelle sont souvent de bonnes options, car ils sont g√©n√©ralement bien inform√©s sur la PrEP et sensibles aux pr√©occupations li√©es √† la sant√© mentale.

N'h√©sitez pas √† poser des questions sur leur approche et leur exp√©rience avec des patient¬∑e¬∑s ayant des pr√©occupations similaires. Si vous ressentez de l'anxi√©t√©, il pourrait √™tre b√©n√©fique de consulter √©galement un professionnel de la sant√© mentale. Prenez soin de vous !",274,140,414
25,2025-09-19T17:48:52.311288,Quelles sont les ressources disponibles pour m'aider √† g√©rer mon anxi√©t√© pendant que je prends la PrEP ?,quelles sont les ressources disponibles pour m'aider √† g√©rer mon anxi√©t√© pendant que je prend5 la pre ?,"Il est tout √† fait compr√©hensible d'avoir des pr√©occupations concernant l'anxi√©t√©, surtout dans un contexte de prise de PrEP. Pour vous aider, voici quelques ressources :

1. **Therapeutes ou psychologues** : Consulter un professionnel de la sant√© mentale peut vous apporter un soutien adapt√©.
2. **Lignes d'√©coute** : Des services d'√©coute et de soutien sont souvent disponibles, offrant une aide imm√©diate.
3. **Groupes de soutien** : Rejoindre des groupes de discussion sur la sant√© mentale ou la PrEP peut vous permettre de partager vos exp√©riences et de vous sentir moins seule.
4. **Applications de bien-√™tre** : Des applications peuvent vous aider √† g√©rer l'anxi√©t√© avec des exercices de respiration et de m√©ditation.

N'h√©sitez pas √† demander de l'aide si vous en ressentez le besoin.",267,174,441
26,2025-09-19T17:48:56.630952,La PrEP peut-elle vraiment affecter mon humeur ou mon niveau d'anxi√©t√© ?,la PrEP peut-elle rva1m3n7 affecter m0n humeru ou mon n1v34u d'anxi√©t√© ?,"La PrEP, qu'elle soit orale ou injectable, est g√©n√©ralement bien tol√©r√©e, mais chaque personne r√©agit diff√©remment. Certaines personnes peuvent ressentir des effets secondaires, y compris des changements d'humeur ou d'anxi√©t√©. Si vous √™tes pr√©occup√©e par l'impact de la PrEP sur votre sant√© mentale, il est important d'en parler √† un professionnel de sant√© qui peut vous fournir des conseils adapt√©s √† votre situation.

Il est normal d'avoir des craintes, surtout apr√®s un traumatisme. N'h√©sitez pas √† chercher du soutien aupr√®s de th√©rapeutes ou de groupes de soutien, qui peuvent vous aider √† g√©rer votre anxi√©t√© et vos pr√©occupations. Votre bien-√™tre est essentiel.",275,144,419
27,2025-09-19T17:49:02.635327,Quelles alternatives √† la PrEP existent si je suis pr√©occup√©e par son impact sur ma sant√© mentale ?,Q-Quelles alternatives √† la PrEP existent si je suis pr√©occup√©e p4r idk son impact 5ur ma sant√© mentale,"Il est compr√©hensible d'avoir des pr√©occupations concernant l'impact de la PrEP sur votre sant√© mentale. Si vous envisagez des alternatives √† la PrEP, vous pouvez explorer d'autres m√©thodes de pr√©vention du VIH, telles que l'utilisation de pr√©servatifs, qui prot√®gent √©galement contre d'autres infections sexuellement transmissibles. Il est √©galement important de discuter avec un professionnel de sant√© qui peut vous aider √† trouver une solution adapt√©e √† vos besoins et √† votre situation personnelle. N'h√©sitez pas √† parler de vos pr√©occupations relatives √† la sant√© mentale ; des ressources professionnelles, comme des th√©rapeutes ou des groupes de soutien, peuvent vous offrir un espace s√ªr pour exprimer vos sentiments.",272,138,410
28,2025-09-19T17:49:12.475505,Comment puis-je aborder mes pr√©occupations concernant la PrEP avec mon m√©decin sans me sentir jug√©e ?,comment puis-je aborder mes um pr√©occupations concernant la Pr3P avec mooon m√©decin sans m3 sentir jug√©e üò≠,"Il est tout √† fait normal de ressentir de l'appr√©hension en abordant la PrEP avec votre m√©decin, surtout dans un contexte personnel difficile. Vous pouvez commencer par expliquer vos pr√©occupations √©motionnelles et mentales, en mentionnant que vous craignez que la PrEP n'aggrave votre anxi√©t√©. Les professionnels de sant√© sont form√©s pour √©couter sans jugement et vous aider √† trouver des solutions adapt√©es. N'h√©sitez pas √† poser des questions sur les effets de la PrEP, qu'elle soit orale ou injectable, et √† exprimer vos inqui√©tudes concernant la stigmatisation. Si vous ressentez le besoin de soutien suppl√©mentaire, envisagez de consulter un professionnel de la sant√© mentale. Votre bien-√™tre est une priorit√©.",270,147,417
29,2025-09-19T17:49:17.759940,Quels sont les effets secondaires de la PrEP sur la sant√© mentale ?,Q-Quels sont les effets secondaires d3 la PrEP sud la sant√© mentale ? ?,"Il n'existe pas de preuves solides que la PrEP, qu'elle soit orale ou injectable, ait des effets directs sur la sant√© mentale. Cependant, certaines personnes peuvent ressentir de l'anxi√©t√© ou des pr√©occupations en lien avec la prise de PrEP, souvent √† cause de la stigmatisation ou de la peur du jugement. Il est important de parler de ces sentiments avec un professionnel de sant√© ou un conseiller qui peut vous soutenir. Si vous ressentez une d√©tresse √©motionnelle, n'h√©sitez pas √† demander de l'aide. Vous m√©ritez d'avoir un soutien adapt√© √† votre situation.",262,122,384
30,2025-09-19T17:49:22.098353,Quelles sont les ressources ou les groupes de soutien disponibles pour m'aider √† g√©rer mon anxi√©t√© li√©e √† la prise de PrEP ?,quelles sont les ressources ou les gr0uppp3s de soutien d1sp0n1bl35 pour m'aider √† g√©rer mon anxi√©t√© li√©e √† la prise de PrEP ?,"Il existe plusieurs ressources et groupes de soutien qui peuvent vous aider √† g√©rer votre anxi√©t√©. Vous pouvez envisager de contacter des associations locales comme AIDES ou le Sidaction en France, qui offrent des services de soutien psychologique et des groupes de parole. Des lignes d'√©coute, comme SOS Suicide ou le 3114, sont √©galement disponibles pour des conversations anonymes. N'h√©sitez pas √† consulter un professionnel de la sant√© mentale qui peut vous aider √† traiter vos pr√©occupations li√©es √† la PrEP et √† votre situation personnelle. Vous m√©ritez un soutien adapt√© et sans jugement.",284,116,400
