turn,timestamp_utc,clean_user,noisy_user,bot,usage.prompt,usage.completion,usage.total
1,2025-09-19T17:42:51.355806,ni n4n1 anayeweza kunisaidia atika kutafuta PrEP bila kuhisi aibu,ni n4n1 anayeweza kunisaidia atika kutaaafuta prep bila kuihsi aibu,"Ninaelewa kuwa unajisikia huzuni na kutengwa kutokana na hali yako ya kiuchumi na wasiwasi kuhusu aibu. Ni muhimu kujua kuwa PrEP, iwe ni vidonge au sindano, ni njia salama na yenye ufanisi ya kujikinga na HIV. Kuna huduma za afya zinazotoa maelezo na msaada bila hukumu. Tafuta vituo vya afya vya karibu ambavyo vinatoa huduma za PrEP, ambavyo vinaweza kuwa na wahudumu wa afya wanaoweza kukusaidia kwa njia ya faragha. Pia, unaweza kuzungumza na wataalamu wa afya kuhusu hisia zako. Usijisikie peke yako; kuna watu wanaotaka kukusaidia.",234,153,387
2,2025-09-19T17:42:55.835546,"Je, kuna vituo vya afya vya karibu ambavyo vinaweza kuniwezesha kupata PrEP bila kuhisi aibu?","je, kuna vituo vya afya vya karibu ambavyo vinaweza kuniwezesha kup474 PrEP hila kuhisi idk aibu?","Ninaelewa kwamba unajisikia aibu na kutengwa na jamii, na hiyo ni hali ngumu. Katika Tanzania, kuna vituo vya afya vingi vinavyotoa PrEP bila kuhukumu. Unaweza kutafuta vituo vya afya vya umma au vya binafsi ambavyo vinatoa huduma za HIV. Wataalamu huko wanaweza kukusaidia kwa faragha na kwa njia inayofaa kwako. 

Kumbuka, PrEP inaweza kuwa njia nzuri ya kujilinda, na unastahili kuwa na msaada. Ikiwa unahitaji mtu wa kuzungumza naye kuhusu hisia zako, tafuta huduma za ushauri za afya ya akili katika eneo lako. Usiwe na wasiwasi; upo katika safari ya kujitunza.",241,164,405
3,2025-09-19T17:43:01.028705,"Je, ni hatua zipi za kwanza ambazo naweza kuchukua kupata PrEP bila kuhisi aibu?",Je ni hatua zip1 like za kwanza ambazo naweza kuchukua kupata PrEP bila ku1s1 aibu?,"Ni muhimu kujua kwamba unavyojijali ni muhimu sana. Kwanza, jaribu kutafuta huduma za afya zinazotoa PrEP, kama vile vituo vya afya au kliniki za HIV. Wengi wa wahudumu wa afya wanatoa huduma hizi kwa faragha na bila hukumu. Unaweza pia kuwasiliana na mashirika ya afya ya jamii ambayo hutoa msaada wa kisaikolojia na taarifa kuhusu PrEP.

Kuhusu matibabu, kuna chaguzi za PrEP za kinywa na sindano, na unaweza kuchagua kile kinachokufaa zaidi. Kumbuka, unayo haki ya kujiweka salama na kujikinga. Ikiwa unahitaji msaada wa kisaikolojia, tafuta wataalamu wa afya ambao wanaweza kusaidia na masuala ya stigma. Usijisikie peke yako katika safari hii.",235,187,422
4,2025-09-19T17:43:05.218020,"Je, kuna vituo vya afya katika maeneo yangu ambavyo vinatoa PrEP bila kuhukumu?","je, kuna vituo vya 4f4 katika maeneo yanug ambavyo vinatoa prep bila kuhukumu?","Ndio, kuna vituo vya afya vinavyotoa huduma za PrEP bila kuhukumu, na mara nyingi vinajitahidi kutoa mazingira ya kuunga mkono. Ni muhimu kutafuta vituo ambavyo vinatoa huduma za afya za kijamii au mashirika yasiyo ya kiserikali katika eneo lako. Wanaweza kuwa na mifumo ya faragha na kuweza kusaidia bila hukumu. Unapohisi wasiwasi kuhusu stigma, ni vizuri kuzungumza na wataalamu wa afya au washauri wa afya ya akili. Wanaweza kutoa msaada zaidi na kukusaidia kujisikia salama. Tafadhali usikate tamaa, kuna msaada na chaguzi zinazopatikana.",235,152,387
5,2025-09-19T17:43:09.800435,Ninaweza vipi kupata taarifa zaidi juu ya vituo vya afya vinavyotoa PrEP bila hukumu katika eneo langu?,ninaweza vipi kupata 744r1f4 zaidi juu ya vituo vya afya vinavyktoa PrEP bila hukumu idk katika eneo langu? âœ¨,"Ni muhimu kupata habari sahihi na msaada kuhusu PrEP. Tafuteni vituo vya afya vya ndani vinavyotoa PrEP na kuzungumza na wataalamu wa afya ambao wanaweza kuwa na uzoefu mzuri na watu kama wewe. Unaweza pia kuangalia mashirika yasiyo ya kiserikali yanayojitolea kusaidia watu katika masuala ya HIV na PrEP, kwani mara nyingi wanaweza kutoa msaada bila hukumu. Ikiwa unahisi huzuni au wasiwasi, tafuta msaada wa kitaaluma, kama vile mtaalamu wa afya ya akili, kwani wanaweza kusaidia katika kukabiliana na hisia hizo. Usiwe na wasiwasi, unastahili kupata huduma hii kwa faraja na usalama.",247,162,409
6,2025-09-19T17:43:13.994474,Ninaweza kupata msaada wa kijamii au vikundi vya usaidizi kuhusu PrEP katika eneo langu?,n-ninaweza kupata m5a4d4 wa kijamii au vikundi vya u541d1z1 kuhusu PrEP katika eneo um lang?u,"Ninaelewa kuwa unajihisi pekee kutokana na hali yako. Ni muhimu kujua kwamba uko peke yako katika hii na kuna watu wengi wanaweza kusaidia. Katika Tanzania, unaweza kutafuta vituo vya afya vinatoa maelezo kuhusu PrEP na pia vikundi vya msaada wa kijamii. Tafuta shirika la afya au NGO zinazoshughulika na masuala ya HIV, kama vile TACAIDS au TNP+. Wanatoa rasilimali muhimu na wanaweza kuwa na vikundi vya kuunga mkono ambavyo vinakupa nafasi ya kuzungumza bila kuhukumiwa. Tafuta huduma za afya za karibu na uulize kuhusu PrEP na msaada wa kijamii. Usijisikie pekee; kuna msaada wa kutosha.",245,163,408
7,2025-09-19T17:43:17.915465,"Je, kuna vituo vya afya katika mji wangu ambapo naweza kupata PrEP bila kuhukumiwa?","je, kuna vi7u0 vya 4fy4 katika mji w4gnu ambapo naweza kupata PrEP bila kuhukumiwa? kuhukumiwa?","Naelewa jinsi unavyoweza kujisikia kuhusu suala la hukumu na upatikanaji wa PrEP. Ni muhimu kupata huduma bila hofu. Katika miji mingi, vituo vya afya vinatoa PrEP kwa siri na kwa msaada wa kitaalamu. Tafuta vituo vya afya ambavyo vinajulikana kwa kutoa huduma za kirafiki, kama vile kliniki za HIV au vituo vya vijana. Pia, unaweza kuzungumza na wafanyakazi wa afya ili kuelewa zaidi kuhusu mchakato na haki zako. Usijizuie; kuna watu na rasilimali wanaweza kusaidia. Ikiwa unahitaji msaada zaidi wa kiakili, tafuta wataalamu wa afya ya akili katika eneo lako.",244,152,396
8,2025-09-19T17:43:22.258237,"Je, kuna vikundi vya msaada au washirika katika jamii yangu wanaweza kunisaidia na masuala ya PrEP na unyanyapaa?","j3, kuna idk vikundi vya smaada au washirika katika jamii yangu wanaweza kunisaidia na masuala yyya rPEP na unyanyapaa?","Ninaelewa kuwa unajisikia kutengwa na kuna vizuizi vinavyokufanya uhisi hivo. Ni muhimu kutafuta msaada kutoka kwa vikundi vya jamii vinavyoweza kusaidia katika masuala ya PrEP na unyanyapaa. Katika Tanzania, unaweza kutafuta mashirika kama TACAIDS au NGO zinazoshughulikia afya ya HIV. Wanaweza kutoa taarifa, msaada wa kijamii, na kuunganisha na watu wengine wanaopitia hali kama yako. Tafuta vikundi vya msaada mtandaoni au kwenye vituo vya afya. Kumbuka, unastahili msaada na hakuna aibu katika kutafuta kinga na afya yako.",247,146,393
9,2025-09-19T17:43:27.335793,"Je, unaweza kunipa taarifa zaidi kuhusu jinsi ya kujiunga na vikundi vya msaada vya PrEP katika jamii yangu?",je unaweza kunip taarifa zaidi kuhusu jinsi ya kujiunga na vikund1 vya msaada vua PrEP katika j41m1 yangu?,"Ninaelewa kuwa unajisikia kutengwa na unahitaji msaada. Vikundi vya msaada vya PrEP vinaweza kuwa njia nzuri ya kupata taarifa na kuungana na watu wengine. Tafuta vituo vya afya katika jamii yako, ambavyo mara nyingi hutoa vikundi vya msaada na maelezo kuhusu PrEP. Unaweza pia kuwasiliana na mashirika yasiyo ya kiserikali yanayofanya kazi katika afya ya HIV kwa msaada wa moja kwa moja. Ni muhimu kutafuta msaada, na kumbuka, unahitaji haki ya kujikinga na afya yako bila kuhisi aibu. Ikiwa unahitaji msaada zaidi, fikiria kuzungumza na mtaalamu wa afya au mshauri wa afya ya akili.",240,157,397
10,2025-09-19T17:43:36.732605,Ni hatua zipi za kuchukua ili kupata PrEP kwa urahisi bila kuhisi aibu katika jamii yangu?,ni hatua z1p1 za kuchukua ili kupata Pr3P i mean kw4 urahisi bila kuisi aiiibu katika jamii yangu ðŸ™„,"Ninaelewa kwamba unajisikia kutengwa na kuna hofu kuhusu stigma. Kwanza, ni muhimu kujua kwamba unahitaji kujiandikisha kwa mtaalamu wa afya ili kupata PrEP, iwe ni kwa vidonge au sindano. Unaweza kuanzisha mazungumzo na daktari wako kuhusu hofu zako ili waweze kukusaidia kwa njia inayofaa.

Pia, tafuta vituo vya afya ambavyo vinatoa huduma za PrEP kwa siri. Wakati mwingine, kuna mashirika yasiyo ya kiserikali yanayotoa msaada wa ziada kwa watu kama wewe. Usijisikie peke yako; kuna watu wanaweza kukusaidia. Kama unahitaji msaada wa kiakili, tafuta wataalamu wa afya ya akili katika eneo lako.",243,168,411
11,2025-09-19T17:43:40.843342,"Je, kuna vituo vya afya katika Tanzania ambavyo vinatoa huduma za PrEP kwa siri na bila majaribio ya jamii?",je kkkuna vituo vya 4fy4 katika like tanzania ambavyo vinatoa huduma za prep kwa siri na bila jajaribio ya jamii,"Ndio, Tanzania ina vituo kadhaa vinavyotoa huduma za PrEP kwa siri. Ni muhimu kutafuta vituo vya afya ambavyo vinaeleweka kwa kutoa huduma kwa usiri na kuheshimu faragha ya wateja. Unaweza kuwasiliana na mashirika yasiyo ya kiserikali yanayoshughulika na HIV, kwani mara nyingi wanaweza kusaidia kutoa taarifa sahihi kuhusu huduma hizo. Tafadhali kumbuka kuwa ni kawaida kuhisi wasiwasi kuhusu unyanyapaa, lakini kuna watu na rasilimali wanaweza kusaidia. Ikiwa unahitaji msaada zaidi wa kiakili, tafuta wataalamu wa afya wa akili katika eneo lako. Usiogope, unastahili kupata huduma bora na msaada.",243,161,404
12,2025-09-19T17:43:44.300324,"Je, ni jinsi gani naweza kupata taarifa zaidi kuhusu huduma za PrEP bila kutambulika katika jamii yangu?",j-je ni jinsi gani naewza kupata taarifa zaidi kuhusu huduma za PrEP bila kutambulika katika jamii yangu,"Ninaelewa kuwa unaweza kujisikia kutengwa na kuwa na wasiwasi kuhusu kujulikana katika jamii yako. Unaweza kupata taarifa zaidi kuhusu huduma za PrEP kwa kutafuta vituo vya afya vinavyotoa huduma hizi kwa faragha. Pia, unaweza kuwasiliana na mashirika yasiyo ya kiserikali yanayoshughulika na masuala ya HIV ili kupata msaada wa siri. Wanaweza kutoa taarifa kuhusu PrEP na jinsi ya kuipata bila kuhisi hukumu. Ni muhimu kujijali na kulinda afya yako. Usisite kuzungumza na wataalamu wa afya au wahudumu wa msaada wa kiakili ikiwa unahitaji msaada zaidi.",234,146,380
13,2025-09-19T17:43:49.669699,Ni vituo gani vya afya katika eneo langu vinatoa huduma za PrEP kwa faragha?,ni vituo like gani vya 4fy4 k471k4 eneo langu vinatoa huduma za Pr3P kwa faragha,"Ninaelewa kwamba unahisi hofu kuhusu stigma na upatikanaji wa PrEP. Ni muhimu kujua kwamba kuna vituo vingi vinavyotoa huduma za PrEP kwa faragha. Tafuta vituo vya afya vya umma, kliniki za HIV, au mashirika yasiyo ya kiserikali katika eneo lako. Mara nyingi, vituo hivi vinatoa huduma za faragha na msaada wa kihisia. Unaweza kuzungumza na wahudumu wa afya kuhusu wasiwasi wako, na wanapaswa kukusaidia kwa njia isiyo na hukumu. Pia, unaweza kufikiria kuwasiliana na mashirika ya afya ya kiakili kwa msaada wa kiakili na kuondoa hofu zako. Hakikisha unajilinda na kujijali.",238,169,407
14,2025-09-19T17:43:54.736440,"Je, kuna njia yoyote ya kufikia huduma za PrEP bila kufichua taarifa zangu binafsi?",Je kuna njua y0y073 ya kufikia huduma za PfEP bila kufichua taarifa zangu binafsi?,"Ndio, kuna njia za kufikia huduma za PrEP bila kufichua taarifa zako binafsi. Katika maeneo mengi, unaweza kupata huduma za PrEP kwa kutumia majina bandia au kwa kuwasiliana na watoa huduma ambao wanaweza kukuhakikishia faragha. Ni muhimu pia kutafuta vituo vya afya ambavyo vinatoa huduma hizi kwa njia ya siri, kama vile kliniki za vijana au huduma za afya za jamii. Tafadhali jisikie huru kuzungumza na wataalamu wa afya kuhusu hofu zako. Unaweza pia kujitafuta msaada wa kitaalamu kuhusu masuala ya kiakili na hisia za unyanyapaa. Kumbuka, unastahili kuwa na afya na kulindwa.",236,156,392
15,2025-09-19T17:43:58.167368,Ninweza kupata wapi taarifa zaidi kuhusu vituo vya afya vinavyotoa huduma za PrEP kwa siri katika eneo langu?,Ninweza kupwta wapi taarfia 41di kuhusu v17u0 vya afya vinavyotoa huduma za like PrEP kwa siri ka71k4 enso langu? ðŸ˜…,"Ni muhimu kupata taarifa sahihi kuhusu PrEP na huduma za afya. Unaweza kuangalia vituo vya afya vya umma, kliniki za afya ya uzazi, au mashirika yasiyo ya kiserikali yanayotoa huduma za HIV katika eneo lako. Mara nyingi, vituo hivi vinatoa huduma kwa siri na bila hukumu. Pia, unaweza kuwasiliana na wataalamu wa afya kwa njia ya simu au mtandaoni ili kupata msaada wa faragha. Usijisikie peke yako; kuna watu wengi wanaweza kukusaidia. Ikiwa unahitaji msaada wa kiakili au wa kihisia, tafuta msaada wa kitaalamu katika jamii yako.",252,143,395
16,2025-09-19T17:44:01.928727,"Je, kuna njia gani rahisi na zenye usiri za kupata PrEP bila kuhisi aibu au hukumu?","je, kun4 njia gani rahidi na zenye usiri za kupata idk PrEP b1l4 kuhisi aibu au hukumu? ðŸ’€","Ninaelewa kwamba unahisi wasiwasi kuhusu stigma na hukumu kuhusiana na PrEP. Njia rahisi na za siri za kupata PrEP ni pamoja na:

1. **Kliniki za Afya ya Jamii**: Wanaweza kutoa huduma za PrEP kwa faragha.
2. **Huduma za Mtandaoni**: Tafuta vituo vya afya vinavyotoa ushauri na huduma za PrEP mtandaoni.
3. **Kampeni za Uhamasishaji**: Angalia mashirika yasiyo ya kiserikali yanayotoa taarifa na msaada kuhusu PrEP.

Ni muhimu kujua kwamba unastahili kulindwa na kuwa na afya bora. Ikiwa unakumbana na hisia ngumu, fikiria kuzungumza na mtaalamu wa afya au mshauri. Unapata msaada!",244,182,426
17,2025-09-19T17:44:05.781630,"Je, unaweza kuelezea jinsi ya kupata kliniki za afya ya jamii zinazotoa PrEP katika eneo langu?","Je, unaweza kuelezea jinsi ya kupata kliniki za 4fy4 ya jamii zinazotoa PrEP ktaika eneo langu?","Ninaelewa kuwa kupata huduma za PrEP inaweza kuwa changamoto, hasa kwa sababu ya hisia za unyanyasaji na upungufu wa msaada. Ili kupata kliniki za jamii zinazotoa PrEP, unaweza kuangalia tovuti za mashirika ya afya ya jamii katika eneo lako au kuwasiliana na vituo vya afya vya ndani. Pia, unaweza kutafuta msaada kutoka kwa mashirika yasiyo ya kiserikali yanayojihusisha na afya ya ngono na HIV. Wanaweza kusaidia kwa kukuelekeza kwenye huduma zinazopatikana. Usijisikie pekee yako; ni muhimu kutafuta msaada na kujua kuwa unastahili huduma hizi.",239,149,388
18,2025-09-19T17:44:09.269312,Ni ipi njia bora ya kuzungumza na daktari wangu kuhusu PrEP bila kuhisi aibu au kutengwa?,n1 ipi njia b0r4 um ya kuzungumza na d4k74r1 wangu kuhusu PrEP bila kuhisi aibu au kutengwa?,"Ni muhimu kujitunza na kujua haki zako. Unaweza kuanza kwa kusema kuwa unataka kujifunza kuhusu njia za kujikinga na HIV. Unaweza kusema, ""Ningependa kujua kuhusu PrEP na jinsi inavyoweza kunisaidia."" Hakikisha unachagua daktari unayeweza kumwamini, na ueleze hisia zako kuhusu aibu na kutengwa. Wanaweza kuwa na utaalamu wa kukusaidia kwa namna nzuri. Kukutana na wataalamu wa afya wanaelewa masuala ya kijamii kunaweza kusaidia kupunguza hofu yako. Pia, unaweza kutafuta vikundi vya msaada katika jamii yako au mtandaoni, ambapo unaweza kujifunza na kushiriki uzoefu bila kuhisi hukumu.",245,161,406
19,2025-09-19T17:44:13.061645,"Je, kuna maeneo au vituo vya afya Tanzania ambavyo vinatoa PrEP kwa urahisi na bila unyanyapaa?","je, kuna maejeo au vituo vya afya tanzania ambavyo vinatoa prep kaa urahisi na bila unyanyapza?","Ndio, kuna vituo vya afya mbalimbali nchini Tanzania vinavyotoa PrEP kwa urahisi. Mara nyingi, huwa na huduma za faragha na usaidizi wa kipekee kwa watu wote, bila kujali hali zao za kifedha au kijamii. Ni muhimu kutafuta vituo vilivyo na mafunzo kuhusu HIV na PrEP, kwani wanaweza kutoa msaada wa ziada na kujibu maswali yako. 

Kuhusu unyanyapaa, ni kawaida kuhisi hofu, lakini kumbuka kwamba unayo haki ya kujilinda bila kuhisi aibu. Ikiwa unahitaji msaada wa kiakili au wa kihisia, tafuta wataalamu wa afya au vikundi vya msaada katika eneo lako. Usiwe na wasiwasi, unahitaji ulinzi na usaidizi.",241,174,415
20,2025-09-19T17:44:16.446298,Ninaweza kupata msaada wa kihisia au wa kijamii kuhusu PrEP wapi nchini Tanzania?,Ninaweza kupata smaada wa kihisia 4u wa kujamii kuhusu Pr3P wapi nchini Tanzania?,"Ni muhimu kujua kwamba unapojaribu kupata taarifa kuhusu PrEP, sio wewe peke yako. Katika Tanzania, unaweza kupata msaada wa kihisia na wa kijamii kutoka kwa mashirika kama vile TACAIDS, ambao wanaweza kusaidia kwa elimu na msaada wa PrEP. Pia, unaweza kutafuta vituo vya afya vinavyotoa huduma za HIV na kuzungumza na wataalamu ambao wanaweza kukusaidia bila hukumu. Jaribu kutafuta vikundi vya msaada ya kijamii ambavyo vinaweza kukupa nafasi ya kushiriki na watu wenye uzoefu kama wako. Usiogope, msaada upo na unaweza kujilinda.",236,139,375
21,2025-09-19T17:44:20.160055,Ni vigumu kiasi gani kupata PrEP katika maeneo ya vijijini Tanzania?,Ni vigumu kisi gani kupata Pr3P katika m43ne0 ya vijijini Tanzania,"Ninaelewa kuwa kupata PrEP katika maeneo ya vijijini Tanzania kunaweza kuwa changamoto kutokana na sababu kama upatikanaji wa huduma za afya, rasilimali na ushirikiano wa jamii. Watu wengi pia wanaweza kuwa na wasiwasi kuhusu unyanyasaji wa kijamii. 

PrEP inapatikana kwa njia ya vidonge vya kila siku au sindano za kila miezi mitatu. Ni muhimu kujua kwamba unayo haki ya kujilinda bila kuhisi aibu. Tafadhali fikiria kuzungumza na mtaalamu wa afya au shirika la afya linalotoa msaada wa karibu ili kupata taarifa zaidi na usaidizi. Unaweza pia kutafuta vikundi vya msaada katika jamii ili usikose uungwaji mkono.",230,167,397
22,2025-09-19T17:44:24.557199,"Je, kuna vituo vya afya katika maeneo ya vijijini ambavyo vinatoa huduma za PrEP bila unyanyasaji wa kijamii?",je kuna vituo vya afya katika maeneo ya vijijini ambavoy vinatoa hudum4 za PrEP bila unyanyasaji w44a kijamii kijamii,"Ndio, kuna vituo vya afya katika maeneo ya vijijini ambavyo vinatoa huduma za PrEP. Ingawa inaweza kuwa vigumu kupata taarifa sahihi, ni muhimu kujua kwamba wengi wa wahudumu wa afya wanafanya kazi kwa maadili na wanahakikisha usiri wa wagonjwa wao. Tafuta vituo vya afya vinavyotambulika na serikali au mashirika yasiyo ya kiserikali. Ikiwa unakabiliwa na unyanyasaji wa kijamii, ni vizuri kuzungumza na mtaalamu wa afya au mshauri ambaye anaweza kusaidia. Usijione pekee yako; kuna watu wengi wanaweza kusaidia na kukupa msaada wa kihisia.",249,148,397
23,2025-09-19T17:44:29.562225,Ni vipi naweza kupata rasilimali za kusaidia kuondoa aibu na unyanyasaji kuhusu PrEP katika jamii yangu?,ni vipi naweza uh kupata rasiilmali za kusaidia ku0ndo4 aibu na unyanyasaji kuusu prep katika jamii y4ngu,"Ninaelewa kuwa unajisikia kukatishwa tamaa na hali ya unyanyasaji na aibu kuhusu PrEP katika jamii yako. Ni muhimu kujua kuwa unapoangazia afya yako, unafanya jambo la maana. Unaweza kuanzisha mazungumzo na watu wa karibu na wewe au kutafuta vikundi vya usaidizi mtandaoni ambavyo vinajadili masuala haya kwa njia ya faragha. Pia, angalia vituo vya afya vya ndani ambavyo vinaweza kutoa maelezo na msaada kuhusu PrEP bila hukumu. Hii inaweza kusaidia kujenga mtandao wa msaada. Ikiwa unahitaji msaada wa kiakili, kuzungumza na mtaalamu wa afya ya akili kunaweza kusaidia. Unastahili kujisikia salama na kuelewa.",245,173,418
24,2025-09-19T17:44:33.577273,"Je, kuna vituo vya afya vya ndani ambavyo vinaweza kutoa PrEP kwa siri bila hukumu?",Je kuna um vituo vya afha vy4 ndani ambavyo vinaweza ku704 PrEP kw4 siri bila hukumu ðŸ« ,"Ndio, kuna vituo vya afya ambavyo vinatoa PrEP kwa siri na bila hukumu. Hizi ni sehemu salama ambapo unaweza kupata taarifa na huduma unazohitaji. Ni muhimu kujua kuwa unapoenda kwenye vituo hivi, wafanyakazi wengi wanaelewa changamoto za stigma na wako tayari kusaidia. 

Pia, unaweza kuangalia shirika la afya la ndani au NGOs zinazojihusisha na masuala ya HIV, kwani mara nyingi wanatoa huduma za PrEP na msaada wa kiakili kwa watu wanaohitaji. Ikiwa unahitaji msaada wa ziada, tafadhali fikiria kuzungumza na mtaalamu wa afya au mshauri wa kiakili. Usijisikie peke yako; kuna watu wengi wanaokusaidia.",239,165,404
25,2025-09-19T17:44:38.175282,"Je, ni hatua gani ninapaswa kuchukua ili kupata PrEP bila kuhisi aibu au kuhukumiwa?","j-je, ni h4tu4 gnai ninapaswa kuchukua ili kupata PrEP bila kuhiis aibu au kuhukumiw4?","Ninakuelewa kuhusu hofu na aibu unazohisi. Ni muhimu kujua kwamba PrEP ni njia salama na yenye ufanisi ya kujikinga na maambukizi ya HIV. Unaweza kupata PrEP kupitia vituo vya afya vya ndani, ambavyo vinaweza kutoa huduma bila hukumu. Pia, kuna matibabu ya mdomo na ya sindano ya PrEP. Ni wazo zuri kuzungumza na mtaalamu wa afya ambaye anaweza kukusaidia kwa ushauri na maelezo zaidi. Ikiwa unahisi huzuni au unahitaji msaada wa kiakili, tafadhali tafuta huduma za kitaalamu. Huenda ukapata faraja na nguvu zaidi katika jamii zinazokusaidia.",243,158,401
26,2025-09-19T17:44:42.948637,"Je, ni vipi naweza kupata vituo vya afya vinavyotoa PrEP bila kukutana na dhihaka kutoka kwa jamii yangu?","j-je, ni vipi naweza kupata v17u vya afya vinavyotoa PrEP bila kukutana na dhihaka kutoka kwa jamii yangu? ðŸ¤”","Ninaelewa kuwa unahisi wasiwasi kuhusu dhihaka na stigma. Kwanza, ni muhimu kujua kwamba PrEP ni njia salama na yenye ufanisi ya kujikinga na HIV. Unaweza kupata PrEP kupitia vituo vya afya vinavyotoa huduma za HIV, ambayo mara nyingi ni ya faragha. Pia, kuna chaguzi za PrEP za kinywa na sindano, hivyo unaweza kuchagua ile inayokufaa zaidi. Tafuta vituo vya afya vinavyotoa huduma hizi kwa siri. Katika maeneo mengi, kuna pia mashirika yasiyo ya kiserikali yanayatoa msaada wa kihisia na taarifa. Usijisikie peke yako; kuna watu wanaweza kukusaidia.",245,155,400
27,2025-09-19T17:44:47.792214,Ni huduma gani za kijamii zinapatikana ili kusaidia kupunguza hisia za dhihaka zinazohusiana na kutumia PrEP?,ni huudma gani za k1j4m1i z1n4p47ik4na 1l1 kusaidia kupunguz4 hisia za dhihaka zinazohusiana na kutumia PrEP,"Ni vizuri kuwa unatafuta msaada kuhusu hisia zako. Kutumia PrEP, iwe ni ya kinywa au ya sindano, kunaweza kusaidia katika kujilinda na HIV, lakini ni kawaida kuhisi wasiwasi kuhusu stigma. Kujifunza zaidi kuhusu PrEP na kuzungumza na wataalamu wa afya kunaweza kusaidia kupunguza hofu hizo. Pia, kutafuta vikundi vya msaada au kujihusisha na mashirika yanayotoa elimu na msaada kuhusu HIV kunaweza kukupatia nguvu na uelewa zaidi. Tafadhali usisite kuzungumza na mtaalamu wa afya au mshauri kuhusu hisia zako na changamoto unazokutana nazo. Wewe si peke yako, na kuna watu wanaoweza kusaidia.",257,162,419
28,2025-09-19T17:44:52.899544,Ni wapi naweza kupata taarifa za kuaminika kuhusu PrEP bila kuhisi dhihaka kutoka kwa jamii yangu?,ni wapi naweza kupata taarifa za kuaminika kuhusu prep bila kuhisi i mean dhihaka kutoka kwa jamii yangu?,"Ninaelewa jinsi unavyohisi kuhusu dhihaka na kutengwa. Ni muhimu kujua kwamba unayo haki ya kujilinda. Unaweza kupata taarifa za kuaminika kuhusu PrEP kupitia vituo vya afya vya serikali, mashirika yasiyo ya kiserikali, au tovuti za afya kama vile UNAIDS na WHO. Pia, unaweza kuzungumza na wataalamu wa afya ambao wanaweza kukupa usaidizi wa faragha. Ikiwa unahitaji msaada zaidi wa kiakili, tafadhali fikiria kuzungumza na mtaalamu wa afya ya akili. Wanaweza kukusaidia kukabiliana na hisia zako na kujenga mtazamo chanya. Unapojitahidi kujikinga, unafanya jambo zuri kwako mwenyewe.",237,164,401
29,2025-09-19T17:44:56.866936,"Je, kuna vikundi vya msaada au mashirika katika Tanzania vinavyoweza kunisaidia kuhusu PrEP bila kuhisi aibu?",j-je kuna i mean v1kund1 vya msaada au mashirika katika tanzania vinavyoweza kunisadiia kuhusu prep bila kuhisi aibu,"Ndio, kuna mashirika kadhaa nchini Tanzania yanayoweza kusaidia kuhusu PrEP kwa njia ya siri na bila hukumu. Unaweza kuwasiliana na Mashirika kama Twaweza, AMREF, au TNP+ (Tanzania Network of People Living with HIV). Mashirika haya yanaweza kukupa taarifa sahihi kuhusu PrEP na pia kusaidia na masuala mengine yanayohusiana na afya yako. Ni muhimu kujua kwamba unastahili kupata msaada bila kuhisi aibu, na watu wengi wanapitia hali kama yako. Ikiwa unahitaji msaada wa kiakili, tafuta wataalamu wa afya au vikundi vya msaada katika eneo lako. Unastahili kujihisi salama na kupokea msaada.",244,160,404
30,2025-09-19T17:45:00.718989,Ninaweza vipi kupata taarifa zaidi kuhusu hizo huduma bila watu wengine kujua?,ninaweaz viiii kupata taarifa zaidi kuhusu hioz huduma bila watu wengine kujua?,"Ninaelewa kuwa unahisi wasiwasi kuhusu faragha na hukumu kutoka kwa wengine. Unaweza kupata taarifa kuhusu PrEP (kifaa cha kuzuia maambukizi ya HIV) bila kujulikana kwa kutembelea vituo vya afya ambavyo vinatoa huduma hizi kwa siri. PrEP inapatikana katika mifumo miwili: vidonge vya kila siku au sindano za kila mwezi. Ni muhimu kujua kwamba unayo haki ya kujilinda bila kuhukumiwa. Ikiwa unahitaji msaada wa kiakili au wa kijamii, tafuta huduma za kitaaluma katika jamii yako. Usijisikie peke yako; kuna watu wanaweza kusaidia.",231,148,379
