turn,timestamp_utc,clean_user,noisy_user,bot,usage.prompt,usage.completion,usage.total
1,2025-09-19T17:20:13.966795,"I had a one-night stand recently and I'm really worried about HIV. Should I consider PrEP, and how can I even get it without a stable address?",i had a one-night stand recently i mean amd I'm reallg worried about HIV Should I consider PrEP and how can I even geeet it without a stable addresa,"It's understandable to feel anxious after a one-night stand, especially regarding HIV. PrEP (pre-exposure prophylaxis) is an effective way to reduce the risk of HIV transmission. There are two options: oral PrEP, which you take daily, and injectable PrEP, which is administered every two months. 

You don't necessarily need a stable address to access PrEP. Many clinics and community health organizations offer services that can accommodate your situation. It might help to connect with a healthcare provider who understands your concerns about stigma and past trauma. 

If you're feeling overwhelmed, consider reaching out to a mental health professional or a support group that specializes in trauma and sexual health. You deserve care that respects your experiences and needs.",267,144,411
2,2025-09-19T17:20:18.061524,What kind of healthcare providers should I look for to ensure I feel safe and understood when discussing PrEP?,what kind of healthcare providers should I l00k for 70o0 ensure I feel safe and understood when discussing PrEP,"It's important to find a healthcare provider who is empathetic, knowledgeable, and experienced in sexual health and HIV prevention. Look for providers who specialize in LGBTQ+ health or sexually transmitted infections, as they often have more awareness of stigma and trauma-informed care. You might also consider clinics that focus on comprehensive sexual health, which often prioritize patient comfort and confidentiality. 

Before making an appointment, you could call and ask about their approach to discussing sensitive topics or how they support patients with PTSD. Seeking a provider who creates a safe space for open dialogue can help ease your anxiety. Remember, your feelings are valid, and you deserve respectful care.",257,126,383
3,2025-09-19T17:20:24.786610,What specific questions should I ask a potential healthcare provider to ensure they are trauma-informed and sensitive to my needs?,what specific questions shoudl I ask q potential healthcare provider to ensure they are traaauma-informed anr sensitive to my needs,"It's great that you're considering how to find a supportive healthcare provider. Here are some questions you might ask:

1. Can you describe your experience with patients who have PTSD or trauma histories?
2. How do you create a safe and comfortable environment for discussing sensitive topics like sexual health?
3. Are you familiar with trauma-informed care principles, and how do you apply them in your practice?
4. Can you explain the process of discussing PrEP, and how do you ensure my comfort throughout?
5. How do you handle situations if a patient feels overwhelmed during a visit?

Remember, it's important to feel safe and understood. Seeking support from a mental health professional can also help with anxiety around healthcare settings.",258,140,398
4,2025-09-19T17:20:29.150510,What resources are available to help me manage my anxiety about discussing PrEP with a healthcare provider?,what reourcew are available to hepp me manage my anxiety about discussing Pr3P with a healthcare provider? provider?,"It's completely understandable to feel anxious about discussing PrEP with a healthcare provider, especially considering your past experiences. Here are some resources that may help:

1. **Support Groups**: Look for local or online support groups for people living with PTSD or those exploring sexual health topics. Connecting with others who share similar experiences can be comforting.

2. **Therapists**: A mental health professional can help you work through your anxiety and develop coping strategies for healthcare interactions.

3. **Hotlines**: Consider reaching out to hotlines that specialize in mental health or sexual health for immediate support and guidance.

4. **Patient Advocates**: Some clinics offer patient advocates who can help you communicate with your healthcare provider and ensure your concerns are addressed.

You're not alone in this, and there are people who can support you.",257,164,421
5,2025-09-19T17:20:32.967875,How can I find a healthcare provider who is sensitive to my PTSD and won't judge me for seeking PrEP?,how can I find a healthcare provider aho is sensitive to my TPSD and won't judge me ror eeking PrEP?,"Finding a healthcare provider who understands PTSD and can support you in seeking PrEP is important. Here are a few steps to consider:

1. **Research Providers:** Look for clinics specializing in LGBTQ+ health or sexual health, as they often have experience with sensitive topics.

2. **Read Reviews:** Check online reviews or ask for recommendations from trusted friends or community groups about providers known for being empathetic.

3. **Contact Clinics:** Reach out to clinics directly. You can explain that youâ€™re looking for a provider who is understanding and sensitive to your experiences.

4. **Seek Support:** If you feel comfortable, consider bringing a supportive friend to the appointment or discussing your concerns with a therapist.

Your feelings are valid, and it's important to prioritize your comfort during these conversations.",257,154,411
6,2025-09-19T17:20:37.139396,What specific questions should I ask a potential healthcare provider to ensure they understand my situation and can support me with PrEP?,what specific quessstions should I aek q potential healthcare providrr 70 ensure they understand my situatoon and can support me with PrEP ðŸ˜…,"It's great that you're considering asking questions to find the right healthcare provider for your PrEP needs. Here are some specific questions you can consider:

1. How do you approach discussions about sexual health and PrEP with patients who have experienced trauma?
2. What steps do you take to ensure a comfortable and judgment-free environment during appointments?
3. Can you explain the differences between oral and injectable PrEP, and which might be suitable for me?
4. How do you handle confidentiality and privacy regarding my health information?
5. What support resources do you offer for patients dealing with anxiety or PTSD?

Remember, it's important to find a provider who makes you feel safe and understood.",264,134,398
7,2025-09-19T17:20:40.748963,What signs should I look for to know if a healthcare provider is genuinely supportive and understanding of my concerns?,w-what signs should I look for to know if a healthcare provider iiis genuienly suplortive and undersanding of my concerns?,"It's important to feel safe and supported when discussing your health. Look for providers who actively listen, ask open-ended questions, and show empathy towards your experiences. They should respect your pace and comfort level, without pushing you to share more than you're ready for. A supportive provider will use inclusive language, avoid judgment, and validate your feelings. If you ever feel uncomfortable, it's okay to seek out another provider who better meets your needs. Remember, you deserve compassionate care tailored to your experiences. If you need additional support, consider reaching out to mental health professionals or community organizations that specialize in trauma-informed care.",261,120,381
8,2025-09-19T17:20:45.316704,What should I do if I feel anxious or triggered during a healthcare appointment when discussing PrEP?,waht should u do if I feel anxious kr triggered during a healthcare appointment hw3n discussing PrEP?,"It's completely understandable to feel anxious or triggered during healthcare appointments, especially when discussing topics like PrEP. Here are some strategies that might help:

1. **Communicate Your Feelings**: Let your provider know about your anxiety and past trauma. A supportive provider can adjust their approach to make you feel more comfortable.

2. **Bring a Support Person**: Having a friend or family member with you can provide emotional support.

3. **Take Breaks**: Donâ€™t hesitate to ask for a moment to breathe or collect your thoughts during the appointment.

4. **Consider Telehealth**: If in-person visits feel too overwhelming, some providers offer virtual appointments.

If you're feeling overwhelmed, it may be helpful to talk to a mental health professional who can support you through these feelings. You're not alone in this!",254,163,417
9,2025-09-19T17:20:48.857789,What specific questions should I prepare to ask my healthcare provider about PrEP to feel more confident during the appointment?,what specific questions shouuuld I prepare to ask my healthcar3e3 provider you know about PrP3 to feel more confident during the appointment? âœ¨ âœ¨,"It's great that you're preparing for your appointment! Here are some questions you might consider asking about PrEP:

1. What are the different types of PrEP available (oral vs. injectable)?
2. How effective is PrEP in preventing HIV?
3. What are the potential side effects?
4. How often will I need to come in for check-ups if I start PrEP?
5. Can you help me understand the process of getting started on PrEP?
6. What support resources do you have for patients who may feel anxious or stigmatized?

Remember, your comfort is important. You can also ask your provider how they handle sensitive topics and ensure a supportive environment.",268,136,404
10,2025-09-19T17:20:52.705856,How can I find a healthcare provider who is sensitive to my concerns about stigma and trauma when discussing PrEP?,how can I find a healthcare provjder wbo is sensitive to my concens about stigma and trauma when discussing PrEP?,"Finding a healthcare provider who understands your concerns about stigma and trauma is important. Here are a few steps you can take:

1. **Research Local Clinics**: Look for clinics specializing in sexual health or HIV prevention. They often have staff trained in trauma-informed care.

2. **Ask for Recommendations**: Reach out to local LGBTQ+ organizations or support groups. They may have lists of providers known for their sensitivity.

3. **Initial Conversations**: When contacting a provider, you can express your concerns upfront. This will help you gauge their understanding and approach.

4. **Telehealth Options**: Consider virtual visits, which might feel less intimidating.

Remember, your comfort and safety are priorities in your healthcare journey.",258,143,401
11,2025-09-19T17:20:56.311160,What specific questions should I ask a potential provider to ensure they understand my needs regarding PTSD and stigma?,Waht specific questions should I ask a potential provdier 70 ensure h3y understand my needs regarding P75D and stigma,"It's important to find a provider who is understanding and supportive. Here are some questions you might consider asking:

1. **Experience with PTSD:** ""How do you approach care for patients with PTSD or past trauma?""
2. **Stigma Awareness:** ""What steps do you take to ensure a non-judgmental environment for discussing sexual health?""
3. **Confidentiality:** ""How do you protect patient confidentiality in your practice?""
4. **Support Resources:** ""Can you recommend resources or support groups for individuals facing stigma or mental health challenges?""
5. **PrEP Options:** ""Can you explain both oral and injectable PrEP options, and help me decide what might work best for me?""

Remember, itâ€™s okay to express your concerns and seek a supportive relationship with your provider.",259,158,417
12,2025-09-19T17:21:01.411792,What should I do if I feel uncomfortable or triggered during my appointment about discussing PrEP or my sexual health?,what shoild I do if I feel uncomfortable or triggered during my i mean appointment about discussing PrEP ir my sexual health?,"It's completely understandable to feel uncomfortable or triggered during discussions about your sexual health. Here are some steps you can take: 

1. **Communicate**: Let your healthcare provider know how you're feeling; they can adjust their approach to make you more comfortable.
2. **Take Breaks**: Donâ€™t hesitate to ask for a moment if you need to collect your thoughts or take a breather.
3. **Bring Support**: Consider having a trusted friend or family member accompany you for emotional support.
4. **Consider Professional Resources**: If anxiety persists, talking to a mental health professional can be beneficial.

Your well-being is essential, and it's okay to prioritize your comfort during these discussions.",257,140,397
13,2025-09-19T17:21:05.619127,What are some strategies I can use to find a supportive healthcare provider who understands my concerns about PrEP and trauma?,What are some strategies I can use to find a supportive healthcare provider who understands my concerns about PrEP and trauma?,"Finding a supportive healthcare provider can make a big difference in your experience. Here are some strategies you might consider:

1. **Research and Reviews**: Look for providers who specialize in sexual health or have experience with trauma-informed care. Online reviews can give insights into others' experiences.

2. **Local Support Groups**: Reach out to local LGBTQ+ or HIV prevention organizations; they often have resources and can recommend providers known for their understanding and support.

3. **Initial Consultation**: Consider scheduling a meet-and-greet to discuss your concerns without committing to treatment. This can help you gauge their understanding and approach.

4. **Communication**: Be open about your needs and concerns. A good provider will listen and prioritize your comfort.

Remember, it's okay to seek a provider who makes you feel safe and respected.",255,163,418
14,2025-09-19T17:21:13.070196,How can I prepare myself emotionally for a conversation about PrEP with a healthcare provider?,H-How can I pr3p4r3 myself emo71oj4lly for a convedsation about PrEP with a healthcare provider provider,"It's completely understandable to feel anxious about discussing PrEP, especially considering your past experiences. Here are some strategies to help you prepare emotionally:

1. **Reflect on Your Goals**: Think about what you want to achieve from the conversation. Understanding your reasons for considering PrEP can help you stay focused.

2. **Practice Self-Compassion**: Remind yourself that it's okay to feel nervous. Be gentle with yourself and acknowledge your feelings.

3. **Write Down Your Thoughts**: Jot down any questions or concerns you have. Having them in front of you can make it easier to express yourself.

4. **Consider Bringing a Support Person**: If you feel comfortable, having someone you trust with you can provide emotional support.

5. **Seek Professional Support**: If these feelings become overwhelming, consider talking to a mental health professional who can help you process your emotions. 

You're taking a brave step by considering this conversation!",264,188,452
15,2025-09-19T17:21:18.159545,What should I do if I feel judged or uncomfortable during my appointment about PrEP?,What should I do if I feel judged or uncomfortable during my appointment about Pr3P ðŸ™‚,"It's understandable to feel anxious about discussing sensitive topics like PrEP, especially if you've experienced trauma. If you feel judged or uncomfortable during your appointment, here are a few steps you can take:

1. **Pause the Conversation**: It's okay to take a moment and express how you're feeling. You can say something like, ""I need a moment to collect my thoughts.""

2. **Communicate Your Needs**: Let the provider know what makes you uncomfortable. This can help them adjust their approach.

3. **Seek Support**: Consider bringing a trusted friend or advocate to your appointment for emotional support.

4. **Find a Different Provider**: If you continue to feel uncomfortable, itâ€™s perfectly fine to seek a different healthcare provider who is more understanding.

Your feelings are valid, and prioritizing your comfort is important. If you're feeling overwhelmed, reaching out to a mental health professional can be beneficial.",250,181,431
16,2025-09-19T17:21:21.906712,How can I find a healthcare provider who is sensitive to my concerns about stigma and trauma?,how can I find a healtchare provider whp is 53ns17i11v3 to my concerns about stigma like and trauma?,"Finding a healthcare provider who is understanding of stigma and trauma is essential. Consider seeking out providers who specialize in sexual health, LGBTQ+ care, or trauma-informed care. You can start by looking online for clinics that highlight their commitment to inclusivity and sensitivity. 

Additionally, organizations like the National LGBTQIA+ Health Education Center or local community health centers can offer resources and referrals. It may help to call ahead and ask about their approach to patient care, ensuring they respect your concerns. Remember, you deserve compassionate care, and it's okay to seek a provider who makes you feel safe and supported.",262,118,380
17,2025-09-19T17:21:26.498032,What specific questions should I ask when I first contact a healthcare provider about PrEP?,what specific questions should I 4sk when I first contatc a healthcare provider about PrE[,"When contacting a healthcare provider about PrEP, it can be helpful to ask the following questions:

1. What are the different types of PrEP available (oral and injectable)?
2. How does PrEP work and what is the effectiveness?
3. What are the potential side effects, and how often will I need to check in for follow-up?
4. Will my insurance cover PrEP, or what are the costs involved?
5. Can you provide a safe space to discuss my concerns, especially regarding privacy and stigma?

Remember, your comfort is important, and you have the right to ask questions and seek a supportive environment. If you feel overwhelmed, consider reaching out to a mental health professional for additional support.",253,143,396
18,2025-09-19T17:21:29.889746,How can I find a healthcare provider who is sensitive to my concerns about stigma and trauma when discussing PrEP?,How can I find a healthcare ppprovider who i5 semsitive to m7 concerns about stigma 4nd trauam when discussinf PrEP,"Finding a healthcare provider who is sensitive to your concerns is important. You might start by looking for clinics or providers that specialize in LGBTQ+ health or sexual health, as they often have experience addressing stigma and trauma. Consider searching for providers who advertise themselves as trauma-informed or who have training in mental health. 

You can also reach out to local organizations focused on HIV prevention or mental health; they may have recommendations. When contacting providers, don't hesitate to express your needs upfront. Remember, it's okay to advocate for yourself and find someone who makes you feel safe and supported.",265,113,378
19,2025-09-19T17:21:33.771682,What specific questions should I ask a potential healthcare provider to ensure they understand my concerns about stigma and trauma?,What specific questions 5h0uld I ask a potential healthcare pr0v13r to ensure they understand my concerns about stigma and ... trauma? ðŸ™‚,"It's great that you're thinking about how to communicate your concerns. Here are some questions you might consider asking:

1. How do you approach discussions about sexual health, especially with patients who have experienced trauma?
2. What steps do you take to ensure a non-judgmental and supportive environment?
3. Can you describe how you handle sensitive topics related to mental health and past trauma?
4. How do you ensure confidentiality and protect patient privacy?
5. Are there resources or support services available for patients who may feel anxious or triggered during appointments?

Remember, it's important to feel comfortable with your provider, so take your time to find someone who meets your needs.",263,132,395
20,2025-09-19T17:21:37.444447,What should I do if I feel uncomfortable during my appointment or if the provider doesn't respect my concerns?,what should I do if 1 feel uncomfortable dufing my appointment oe if i mean the provider doesn't respect my doncerns,"It's completely valid to feel uncomfortable during a healthcare appointment, especially regarding sensitive topics. If you find yourself in this situation, you can try to express your feelings to the provider. Let them know if something is triggering or if you feel your concerns arenâ€™t being respected. 

You have the right to a safe and supportive environment. If the interaction doesnâ€™t improve, consider seeking another provider who specializes in LGBTQ+ health or trauma-informed care. You might also want to bring a supportive friend or family member to your appointment. Remember, your mental and emotional well-being is important, and there are professionals who understand and can help.",257,124,381
21,2025-09-19T17:21:42.680126,What are some strategies I can use to prepare for my appointment and feel more comfortable discussing PrEP?,WWWhat are some strategies I can use to prwpare for my appointment anc feel more comfortable discussing PrEP?,"It's completely understandable to feel anxious about discussing PrEP, especially given your experiences. Here are some strategies that might help:

1. **Prepare Questions**: Write down any questions or concerns you have about PrEP. This can help you feel more in control during the conversation.

2. **Bring a Support Person**: If possible, take a trusted friend or family member with you for emotional support.

3. **Choose the Right Provider**: Look for healthcare providers known for being LGBTQ+ friendly and trauma-informed, which can help reduce feelings of stigma.

4. **Practice Self-Care**: Before the appointment, engage in activities that help you relax, such as deep breathing or mindfulness exercises.

5. **Communicate Your Needs**: Let the healthcare provider know about your PTSD and any triggers you might have. A good provider will be understanding and accommodating.

If you find that anxiety or stigma is overwhelming, consider speaking with a mental health professional who can provide additional support.",255,196,451
22,2025-09-19T17:21:46.970235,What should I do if I feel uncomfortable with the provider during my appointment?,h47 shuld k do if I feel uncomfortable idk with the provider during my appointment appointment,"It's completely understandable to feel uncomfortable during a healthcare appointment, especially when discussing sensitive topics. If you find yourself feeling uneasy, consider these steps: 

1. **Communicate:** Let the provider know how you're feeling. They should be open to adjusting the conversation or approach to make you more comfortable.

2. **Take a Break:** If needed, ask for a moment to gather your thoughts or step outside for a breather.

3. **Bring Support:** If possible, have a trusted friend or advocate accompany you for emotional support.

4. **Seek Alternatives:** If the provider doesnâ€™t feel right, you can always look for another who specializes in trauma-informed care.

Remember, your comfort and well-being are important.",251,143,394
23,2025-09-19T17:21:51.364449,What are some ways to find a trauma-informed healthcare provider who understands my concerns about discussing sexual health and PrEP?,what 4r3 some wqys to find a trauma-informed healthcare provider who undrrstands my concerns about discussing sexal health and PrEP?,"Finding a trauma-informed healthcare provider is essential for your comfort and well-being. Here are some steps you can take:

1. **Research**: Look for local clinics or healthcare providers that specifically mention trauma-informed care or LGBTQ+ friendly services.

2. **Ask for Recommendations**: Reach out to support groups or organizations focused on HIV prevention and mental health; they may have lists of providers known for their understanding approach.

3. **Read Reviews**: Online reviews can give insight into other patients' experiences, especially regarding sensitivity and understanding of trauma.

4. **Initial Contact**: When you call or email, ask about their experience with trauma-informed care and how they handle discussions around sexual health. 

Remember, itâ€™s important to feel safe and respected in your healthcare journey.",263,155,418
24,2025-09-19T17:21:54.960279,What specific questions should I ask a potential provider to ensure they are trauma-informed?,What specific questions shoudl I adk a potential provider to ensure they ar3 7r4uma-1nf0rm3d 7r4uma-1nf0rm3d,"It's great that you're thinking about finding a provider who understands trauma. Here are some questions you can ask:

1. How do you approach care for patients with a history of trauma?
2. What steps do you take to create a safe and comfortable environment for your patients?
3. Can you explain how you handle sensitive topics, like sexual health, with understanding and compassion?
4. Are you familiar with trauma-informed practices in your healthcare approach?
5. How do you support patients who may feel anxious or triggered during appointments?

These questions can help you find a provider who respects your experiences and prioritizes your comfort. Remember, seeking support is a strong step forward.",273,132,405
25,2025-09-19T17:21:58.180529,What should I do if I feel uncomfortable during my appointment with a healthcare provider?,what should I do if I fesl uncomfottable during my 4ppo1jtm3n7 with w healttthcare provider?,"It's completely okay to feel uncomfortable during a healthcare appointment. If you feel this way, you might consider taking a few steps to help manage the situation. First, remember that you have the right to speak up and express your feelings to the provider. You can say, ""I'm feeling a bit anxious; can we go slower?"" If it feels overwhelming, you can also ask to take a break or reschedule for another time. Bringing a supportive friend or family member can also help you feel more at ease. If you need extra support, consider reaching out to a mental health professional who can help you navigate these feelings.",264,123,387
26,2025-09-19T17:22:02.345262,How can I find a healthcare provider who understands my concerns about stigma and trauma?,how can i um find a healthcare provider whl understands mmmy concerns about stigma anx 7r4um4?,"Finding a healthcare provider who understands your concerns about stigma and trauma is important. Here are a few steps you can take:

1. **Research Providers**: Look for clinics or providers that specialize in LGBTQ+ health or trauma-informed care, which often prioritize understanding and sensitivity.

2. **Ask for Recommendations**: Reach out to local support groups or online forums where people share their experiences with healthcare providers.

3. **Contact Clinics**: When you call, you can ask if they have experience working with patients who have PTSD or anxiety about stigma.

4. **Trust Your Instincts**: Choose a provider who makes you feel comfortable and respected. You can always find someone else if it doesnâ€™t feel right.

Remember, seeking help is a brave step. If you continue to feel overwhelmed, consider talking to a mental health professional for support.",256,169,425
27,2025-09-19T17:22:08.150630,What specific questions should I ask a healthcare provider to ensure they are sensitive to my experiences with PTSD and stigma?,what specific questions snould um i ask a healthcare proivder to ensure they are sensitive to my experiences qith p7sd and stigma? ðŸ˜¬,"It's important to feel comfortable and understood when discussing your health. Here are some questions you might consider asking:

1. **Experience with PTSD**: ""How do you approach patients with PTSD or anxiety in sensitive situations?""
2. **Stigma Awareness**: ""What steps do you take to create a non-judgmental environment for discussing sexual health?""
3. **Confidentiality Practices**: ""How do you ensure that my information is kept private and secure?""
4. **Support Resources**: ""Can you recommend any resources for mental health support related to sexual health?""

Remember, it's okay to communicate your concerns upfront. You deserve compassionate care! If you ever feel overwhelmed, seeking support from a mental health professional can be beneficial.",263,148,411
28,2025-09-19T17:22:12.346654,What can I do if I feel uncomfortable during my appointment while discussing PrEP or my sexual health?,what can 1 d0 if I feel uncomfortable during my appointment while discussing PrE or my sexual health ðŸ’€,"It's completely understandable to feel uncomfortable discussing sexual health, especially with past trauma. Here are a few steps to consider:

1. **Communicate Your Feelings**: Let your healthcare provider know about your discomfort. They can adjust their approach to make you feel safer.
   
2. **Bring a Support Person**: If possible, have a trusted friend or family member accompany you for moral support.

3. **Take Your Time**: You can set the pace of the conversation. Don't hesitate to pause or ask for breaks if needed.

4. **Consider Telehealth**: Some providers offer virtual appointments, which might feel less intimidating.

If you're feeling overwhelmed, consider reaching out to a mental health professional who specializes in trauma. You're not alone in this!",255,151,406
29,2025-09-19T17:22:15.894146,What should I look for in a healthcare provider to ensure they are supportive and understanding of my background and concerns?,What shou.d I look for in a healthcare provider yo ensure they are supportive and understanding of myyy background and concerns? concerns?,"It's important to find a healthcare provider who makes you feel safe and respected. Look for someone who has experience with LGBTQ+ health and trauma-informed care. You can ask about their approach to discussing sensitive topics and how they ensure privacy and confidentiality. A supportive provider will listen actively, validate your feelings, and take your concerns seriously without judgment. Consider seeking recommendations from trusted friends or support groups. Many organizations also provide directories of affirming healthcare providers. If you feel overwhelmed, reaching out to a mental health professional can help you navigate these conversations. Your comfort matters!",259,111,370
30,2025-09-19T17:22:20.107300,What specific questions can I ask a potential healthcare provider to understand their approach to trauma-informed care?,Wgat specific questions can I ask a potential healthcare provider to understand their approach to trauma-informed care,"It's great that you're considering how to ensure your healthcare provider is trauma-informed. Here are some questions you might ask:

1. How do you create a safe and welcoming environment for patients with a history of trauma?
2. Can you describe your approach to patient confidentiality and privacy?
3. How do you handle sensitive topics, like sexual health, in a way that respects my comfort level?
4. What steps do you take to ensure that your staff is trained in trauma-informed care?
5. How can I communicate my needs or concerns during our appointments?

These questions can help you gauge their understanding and approach to trauma-informed care. Remember, itâ€™s important to feel safe and supported in your healthcare journey.",251,140,391
