turn,timestamp_utc,clean_user,noisy_user,bot,usage.prompt,usage.completion,usage.total
1,2025-09-19T17:45:03.160609,is it common for people in my situation to feel overwhelmed 4b0u7 accessing prep,is it common for people in my situation to feel overwhelmed 4b0u7 accessing prep prep,"Yes, it's completely normal to feel overwhelmed when accessing PrEP, especially if you have concerns about communicating your needs. Many people face similar challenges, and it's okay to feel anxious about discussing your health. Remember, healthcare providers are there to help you, and it's important to express your needs. Writing down your questions or concerns before an appointment can be helpful. You can also ask if you could bring a friend or advocate to support you during discussions. If you're feeling particularly anxious, consider reaching out to a mental health professional or support group for additional guidance. You're not alone in this!",235,116,351
2,2025-09-19T17:45:07.400299,What specific questions should I prepare to ask my healthcare provider about PrEP?,what specific questions should i mean i prepare to ask my healthcare provider abut prep,"It's great that you want to communicate with your healthcare provider about PrEP! Here are some helpful questions to consider:

1. **What is PrEP, and how does it work?**
2. **What are the differences between oral and injectable PrEP?**
3. **Who is a good candidate for PrEP?**
4. **What are the potential side effects?**
5. **How often do I need to take it or get injections?**
6. **What tests or follow-ups are required while on PrEP?**
7. **How can I talk about my concerns or any side effects I might experience?**

Feel free to bring a list of questions to your appointment. It‚Äôs okay to ask for clarification if something isn‚Äôt clear!",231,153,384
3,2025-09-19T17:45:11.172789,How can I ensure my healthcare provider understands my learning disability when discussing PrEP and my health needs?,h-how can I 3n5ur3 my healthcare prvider udnerstands my learning disability when discussing like PrEP and ... my health needs üò¨,"It‚Äôs completely understandable to feel anxious about discussing your needs with healthcare providers. Here are some tips to help communicate effectively:

1. **Prepare in Advance**: Write down your questions or concerns about PrEP and your health needs. This can help you stay focused during the conversation.

2. **Be Honest**: Let your provider know about your learning disability. You can say something like, ‚ÄúI sometimes have difficulty processing information, so I may need things explained in a different way.‚Äù

3. **Ask for Clarification**: If something isn‚Äôt clear, don‚Äôt hesitate to ask them to explain it again or in simpler terms.

4. **Bring Support**: If possible, bring a friend or family member to help advocate for you.

Remember, your health matters, and it‚Äôs okay to ask for what you need!",247,166,413
4,2025-09-19T17:45:15.000776,What specific questions should I prepare to ask my healthcare provider about PrEP?,Wh4t specific questions shooould I prepare to ask my heqlthcare provider about PrEP?,"It‚Äôs great that you‚Äôre preparing to discuss PrEP with your healthcare provider! Here are some specific questions you might consider asking:

1. What are the different types of PrEP available, and how do they work?
2. How often do I need to take the oral medication, or how often do I get the injectable form?
3. What are the possible side effects, and how can I manage them?
4. How will you monitor my health while I‚Äôm on PrEP?
5. What should I do if I miss a dose?
6. Can you help me understand how PrEP fits into my overall sexual health plan? 

Remember, it‚Äôs okay to take notes or ask for clarification during your appointment. You deserve to have your questions answered!",237,153,390
5,2025-09-19T17:45:18.252464,How can I ensure that my healthcare provider understands my learning disability and communication needs during our discussion about PrEP?,How can I ensure taht my um healthcare provider understands my learniiing disability and communication needs during our discussion about PrEEEP,"It‚Äôs important to feel comfortable sharing your needs with your healthcare provider. You can start by clearly stating that you have a learning disability and may need extra time or support to understand information. Consider writing down your concerns and questions in advance, which can help guide the conversation. You can also ask for clarification if something isn‚Äôt clear. 

If you feel anxious, bringing a supportive friend or family member can help. Remember, healthcare providers are there to assist you, and it‚Äôs okay to advocate for yourself. If you're feeling overwhelmed, professional resources like support groups or counselors can provide additional help.",240,118,358
6,2025-09-19T17:45:22.894817,What specific questions should I prepare in advance to discuss PrEP with my healthcare provider?,What specific questions should I prepare idk in advance to discuss PrEP wit my healthcare provider,"It's great that you're preparing to discuss PrEP with your healthcare provider! Here are some questions you might consider:

1. What are the differences between oral and injectable PrEP?
2. How effective is PrEP in preventing HIV?
3. What are the potential side effects?
4. How often will I need to come in for check-ups?
5. Can you help me understand how to take PrEP consistently?
6. What should I do if I miss a dose?
7. Are there any resources or support groups for people starting PrEP?

Writing these down can help you feel more confident during your appointment. Remember, it's okay to ask for clarification if you don‚Äôt understand something!",233,138,371
7,2025-09-19T17:45:27.397889,How can I make sure my doctor understands my learning disability when discussing my health needs?,how cccan I make sure my doctor understands my idk learning disability when discussing my health needs? üò≠ üò≠,"It's completely okay to feel anxious about discussing your health needs. Here are some steps you can take to help communicate effectively with your doctor:

1. **Prepare Ahead**: Write down your concerns and questions before your appointment. This can help you stay focused during the visit.

2. **Be Honest**: Let your doctor know about your learning disability. You can say something like, ‚ÄúI sometimes struggle to process medical information, and I want to make sure I understand everything clearly.‚Äù

3. **Ask for Clarification**: If something isn‚Äôt clear, don‚Äôt hesitate to ask your doctor to explain it differently or repeat it.

4. **Bring a Support Person**: Having someone with you can help you feel more comfortable.

Remember, your health is important, and a good doctor will want to understand your needs. If you're feeling overwhelmed, professional support can also be helpful.",239,176,415
8,2025-09-19T17:45:31.740365,What specific questions should I prepare to ask my doctor about PrEP?,whattt specifci questions should 1 prep4r3 70 ask my doctor about PrEP,"It‚Äôs great that you want to communicate your needs! Here are some specific questions you can ask your doctor about PrEP:

1. What are the differences between oral and injectable PrEP?
2. How effective is PrEP in preventing HIV?
3. What are the potential side effects?
4. How often will I need to come in for check-ups?
5. What tests will I need before starting PrEP, and how often will I be tested?
6. How do I take PrEP correctly, and what should I do if I miss a dose?
7. Can you help me understand the costs and insurance coverage for PrEP?

Feel free to write these down or bring someone to help you during your appointment!",235,145,380
9,2025-09-19T17:45:34.957039,How can I ensure my doctor understands my learning disability and my specific concerns about PrEP?,how can i ensure my doooctor understands my learjing d154b1l17y and ... my specific c0nc3rrrn5 about prep?,"It's important to communicate your needs clearly to your doctor. You might start by writing down your concerns and questions about PrEP before your appointment. This way, you can refer to your notes during the conversation. You can also let your doctor know about your learning disability, so they can adjust their explanations to be more accessible for you.

If you're feeling anxious, consider bringing a trusted friend or family member for support. Also, don't hesitate to ask for clarification if something is unclear. Remember, you deserve to be heard and understood. If you ever feel overwhelmed, seeking support from a counselor or therapist can be helpful.",248,122,370
10,2025-09-19T17:45:39.767763,What specific questions should I prepare to ask my doctor about PrEP?,what specific questions 5h0uld I prepare to ask my doctor about PEP?,"It's great that you're preparing to discuss PEP with your doctor! Here are some questions you might consider:

1. What is PEP, and how does it work?
2. How soon after potential exposure should I start PEP?
3. What are the possible side effects of PEP?
4. How long will I need to take PEP?
5. Are there any alternative options to PEP, like PrEP?

You can write these questions down to help you during your appointment. Remember, it's okay to ask for clarification if something isn't clear! If you need more support, consider reaching out to a patient advocate or counselor who can help you communicate your needs.",233,135,368
11,2025-09-19T17:45:42.941363,How can I ensure my doctor understands my learning disability when discussing PrEP?,how can j ensurr my doctor understands my learning disability when discussing prep ü´†,"It‚Äôs important to feel comfortable discussing your needs with your doctor. You might start by telling them about your learning disability and how it affects your understanding of medical information. You can ask them to explain things in simpler terms or to take breaks during discussions if needed. Writing down your questions or concerns ahead of time can also help guide the conversation. Remember, healthcare providers are there to support you, and it‚Äôs okay to ask for help in ensuring clear communication. If you feel anxious, consider bringing a friend or advocate to your appointment for additional support.",232,109,341
12,2025-09-19T17:45:47.666094,What specific questions should I prepare in advance to discuss PrEP with my doctor?,what specific questions should i preare in advanceee to d15cu55 prep with my d0ct0r?,"It's great that you're preparing for your discussion about PrEP! Here are some specific questions you might consider asking:

1. What are the different options for PrEP, including oral and injectable?
2. How does PrEP work in preventing HIV?
3. What are the potential side effects of PrEP?
4. How often will I need to come in for check-ups while on PrEP?
5. What should I do if I miss a dose of oral PrEP?
6. Are there any interactions with other medications I should be aware of?

Feel free to write these down and bring them to your appointment. It‚Äôs okay to ask for clarification if something is unclear. You deserve to be heard and understood!",239,143,382
13,2025-09-19T17:45:51.268004,How can I effectively explain my learning disability to my doctor to ensure they understand my communication needs?,h-how can I effectively explain my learning dsability to my dotor to ensure they und3rst4nd my vommunication needs,"It's really important to feel comfortable discussing your needs with your doctor. You might start by simply saying, ‚ÄúI have a learning disability that makes it challenging for me to process information quickly. I may need extra time or support to understand things clearly.‚Äù You can also ask them to explain things in simpler terms or to repeat information if you‚Äôre unsure. Bringing a written list of your concerns or questions can help guide the conversation. Remember, you deserve to be heard and understood. If you feel anxious, consider bringing a trusted friend or family member to support you.",242,111,353
14,2025-09-19T17:45:55.175032,What specific questions should I prepare to ask about PrEP during my appointment?,what specific questions should I prepae yo ask about PrEP during my appointment?,"It's great that you're preparing for your appointment! Here are some specific questions you might consider asking about PrEP:

1. What are the differences between oral and injectable PrEP?
2. How effective is PrEP at preventing HIV?
3. Are there any side effects I should be aware of?
4. How often do I need to come in for check-ups while on PrEP?
5. What tests will I need to take before starting PrEP?
6. How much does PrEP cost, and are there any financial assistance programs available?
7. Can you help me understand how to take PrEP consistently?

Feel free to write these down or ask for clarification during your appointment. You're doing a great job advocating for your health!",232,147,379
15,2025-09-19T17:45:58.826846,How can I express my concerns about my learning disability to my doctor in a way that helps them understand my needs better?,How can I express my concerns 4bou7 uh my l34rm1ng disability to my doctor in a way that helps them understand my needs better,"It's completely understandable to feel anxious about discussing your needs with your doctor. A good approach is to prepare a simple list of what you'd like to share. You can explain that you have a learning disability, which makes it harder for you to process information. You might say, ""I sometimes have difficulty understanding medical information, so I may need things explained in a different way."" Don't hesitate to ask for clarification if something isn't clear. You can also bring a friend or advocate for support. Remember, it's okay to express your needs, and healthcare providers are there to help you. If you feel overwhelmed, consider contacting a local support group or a mental health professional for additional guidance.",246,134,380
16,2025-09-19T17:46:02.333055,What specific questions should I prepare in advance to discuss PrEP with my doctor?,w-what specific questions ssshould I prepare in advance to discuss PrEP wiiirh my doctor,"It's great that you're planning to discuss PrEP with your doctor! Here are some helpful questions to consider:

1. What are the differences between oral and injectable PrEP?
2. How effective is PrEP at preventing HIV?
3. What are the potential side effects?
4. How often will I need to come in for follow-ups?
5. Will my insurance cover the cost of PrEP?
6. What other STI tests will I need while on PrEP?
7. How can I stay on track with taking PrEP?

You can write these down or practice them with someone you trust to feel more comfortable. Remember, it's okay to ask for clarification if you don‚Äôt understand something!",237,139,376
17,2025-09-19T17:46:06.126361,How can I ensure my doctor listens to my concerns about PrEP and understands my learning disability?,how can I ensure um my doctor listens 70 my c0nc3rn5 about PPPrEP and ... understands my learning disabilify? üôÇ,"It‚Äôs great that you want to advocate for yourself! Here are some tips to help you communicate effectively with your doctor about PrEP:

1. **Write It Down**: Prepare a list of your concerns and questions before your appointment. This can help you stay focused.

2. **Be Honest**: Let your doctor know about your learning disability and that you sometimes find it hard to process information. They can adjust their communication style to help you better.

3. **Ask for Clarification**: Don‚Äôt hesitate to ask your doctor to explain things in a different way if you don‚Äôt understand.

4. **Bring Support**: If possible, have a trusted friend or family member accompany you to help convey your needs.

Remember, your health is important, and you deserve to be heard!",246,159,405
18,2025-09-19T17:46:09.600022,What specific questions should I prepare to ask my doctor about PrEP?,what specific questions should i prepare to ask jy doctor you know about prep,"It's great that you're preparing to talk to your doctor! Here are some specific questions you might consider asking about PrEP:

1. What is PrEP, and how does it work to prevent HIV?
2. What are the differences between oral and injectable PrEP?
3. Who is a good candidate for PrEP?
4. What are the potential side effects of PrEP?
5. How often do I need to come in for check-ups while on PrEP?
6. How can I express my concerns or ask questions during our appointments?

Remember, it‚Äôs okay to ask for clarification if you don‚Äôt understand something. You deserve clear communication about your health!",229,133,362
19,2025-09-19T17:46:14.550702,How can I make sure my doctor understands my learning disability during our conversation about PrEP?,How caj I make sur3 my like doctor understands my learnign disability dur1ng our conversation about PrEP? üò≠,"It‚Äôs completely understandable to feel anxious about discussing your learning disability with your doctor. Here are some steps you can take to help communicate your needs clearly:

1. **Prepare Ahead**: Write down your concerns and questions about PrEP and your learning disability. This can help you stay focused during the conversation.

2. **Be Open**: At the beginning of your appointment, let your doctor know that you have a learning disability. This can help them tailor their communication style to suit you better.

3. **Ask for Clarification**: If something isn‚Äôt clear, don‚Äôt hesitate to ask your doctor to explain it in simpler terms.

4. **Bring Support**: If you feel comfortable, consider bringing a friend or family member to help communicate your needs.

Remember, your healthcare provider is there to help you, and it‚Äôs okay to advocate for yourself!",240,173,413
20,2025-09-19T17:46:18.330280,What specific questions should I prepare to ask my doctor about PrEP to ensure I get the information I need?,what specific questions should i prepare to ask my d0ct0r about prep to ensuuure i get the information i 3n3d üòï,"It's great that you're planning to have an open conversation with your doctor! Here are some questions you might consider asking about PrEP:

1. What is PrEP, and how does it work?
2. What are the differences between oral and injectable PrEP?
3. Who is eligible for PrEP?
4. What are the potential side effects, and how often should I be monitored?
5. How do I take oral PrEP correctly, and how often do I need the injection?
6. How do I talk to my partner(s) about using PrEP?

You can also let your doctor know about your learning disability so they can provide information in a way that works best for you. Remember, it's okay to ask for clarification if something isn't clear!",247,152,399
21,2025-09-19T17:46:21.870511,How can I effectively explain my learning disability to my doctor so they can help me understand PrEP better?,hoq can I effcetively explain my leeearning disability to my doctor you know so they can help me understand PrEP better?,"It's great that you want to communicate your needs to your doctor. You can start by simply stating, ‚ÄúI have a learning disability, which makes it harder for me to process information. I might need things explained differently or more slowly.‚Äù You can also ask them to summarize key points or provide written materials to help you. Consider bringing a friend or family member for support during the appointment. Remember, your health matters, and it‚Äôs okay to ask for what you need. If you feel anxious, seeking support from a counselor or support group can also be helpful. You're not alone in this!",242,118,360
22,2025-09-19T17:46:26.048143,What specific questions should I ask my doctor about PrEP to ensure I understand my options?,what specific questions i mean should i ask my doctor about prep to ensure i understand my options?,"It's great that you're preparing to talk to your doctor about PrEP! Here are some questions you might consider asking:

1. What are the differences between oral and injectable PrEP?
2. How often do I need to take the oral PrEP, or how often will I receive the injectable version?
3. What are the possible side effects of both options?
4. How can I best remember to take the oral PrEP daily?
5. What support is available if I experience side effects or have questions later on?
6. Can you help me understand the importance of regular follow-ups while on PrEP?

Feel free to write these down or bring someone with you for support. Your health is important, and it's okay to ask for clarification.",234,149,383
23,2025-09-19T17:46:30.760056,How can I communicate my concerns about PrEP side effects to my doctor in a way that ensures they understand my needs?,how can I communicage idk my concerns about PrEP side effects to my doctor in a waaay that en5ur35 they understand my needs üòÖ,"It's great that you're looking to communicate your concerns! Here are some tips that might help:

1. **Write It Down**: Before your appointment, jot down your main concerns about PrEP side effects. This can help you stay focused during the conversation.

2. **Be Direct**: Start by saying, ‚ÄúI have some concerns about PrEP and its side effects. Can we discuss them?‚Äù

3. **Ask Questions**: If you don‚Äôt understand something, it‚Äôs okay to ask for clarification. You can say, ‚ÄúCould you explain that in a different way?‚Äù

4. **Request Support**: If you feel comfortable, let your doctor know about your learning disability. They can help tailor the information to your needs.

Remember, it‚Äôs important to feel understood and supported!",247,158,405
24,2025-09-19T17:46:34.505881,What specific questions should I prepare to ask my doctor about PrEP to ensure I get the information I need?,what specific questions should i prepare ttto ask like my doctor about prep to ensure i g37 the information i need,"It's great that you're preparing to talk to your doctor about PrEP! Here are some questions you might consider asking: 

1. What are the different types of PrEP available, including oral and injectable options?
2. How effective is PrEP in preventing HIV?
3. What are the potential side effects, and how can they be managed?
4. How often will I need to come in for check-ups while on PrEP?
5. What should I do if I miss a dose of oral PrEP?
6. Are there any interactions with other medications I should know about?

Remember, it's okay to take notes or ask for clarification if something isn‚Äôt clear. You deserve to have your needs understood!",238,142,380
25,2025-09-19T17:46:38.596346,How can I effectively communicate my learning disability to my doctor so they understand my needs regarding PrEP?,how can I effectively commun1c4t3 mg learbing disability to my doctor so they understand um my needs regarding PrEP?,"It's great that you want to communicate your needs! Here are some tips:

1. **Prepare Ahead**: Write down your thoughts or questions about your learning disability and how it affects your understanding of PrEP. 

2. **Be Honest**: Start the conversation by saying you have a learning disability that makes processing information challenging. 

3. **Ask for Clarification**: If something isn‚Äôt clear, don‚Äôt hesitate to ask your doctor to explain it differently or to slow down.

4. **Bring Support**: Consider bringing a trusted friend or family member to help advocate for you.

5. **Use Visual Aids**: If you find it helpful, ask for brochures or handouts that you can review later.

Remember, your healthcare provider is there to help you!",242,157,399
26,2025-09-19T17:46:42.357681,What specific questions should I prepare to ask my doctor about PrEP to ensure I get the information I need?,what specific questions you know should I pr3par3 to ask my doctor about PrEP to ensure I get the information I need üòï,"It's great that you're thinking about how to communicate your needs! Here are some questions you might consider asking:

1. What is PrEP, and how does it work to prevent HIV?
2. What are the differences between oral and injectable PrEP, and which might be better for me?
3. How often will I need to come in for check-ups if I start PrEP?
4. What are the potential side effects, and how can I manage them?
5. What should I do if I miss a dose of PrEP?

Feel free to write these down or bring a friend for support. It‚Äôs important to feel comfortable and understood during your appointment!",243,133,376
27,2025-09-19T17:46:47.650172,How can I make sure my doctor understands my learning disability when I discuss PrEP with them?,how can i make sure my doctod understandx my learning d15ab1l17y when i discuss prep with them? them?,"It's great that you're thinking about how to communicate your needs with your doctor. Here are some tips: 

1. **Prepare Notes**: Write down your concerns and questions about PrEP beforehand. This can help you stay focused during your appointment.

2. **Be Open**: Let your doctor know about your learning disability at the beginning of your conversation. This can help them adjust their communication style.

3. **Ask for Clarification**: If something isn't clear, don't hesitate to ask them to explain it in a different way.

4. **Bring a Support Person**: Consider having a trusted friend or family member accompany you for support.

Remember, it's okay to express your needs, and a good healthcare provider will want to help you understand.",243,150,393
28,2025-09-19T17:47:02.208014,What specific questions should I prepare to ask my doctor about PrEP?,um hWat specific qjesions should I prepare to ask my doctor about Pr3P,"It's great that you want to prepare for your appointment! Here are some specific questions you can ask your doctor about PrEP:

1. What are the different types of PrEP available (oral and injectable)?
2. How effective is PrEP in preventing HIV?
3. What are the possible side effects?
4. How often do I need to get tested while on PrEP?
5. Will PrEP interact with any medications I‚Äôm currently taking?
6. How can I access PrEP, and what are the costs?

Writing these down can help you feel more confident during your conversation. If you ever feel anxious, it‚Äôs okay to ask the doctor to explain things more slowly or clarify. You're not alone in this!",233,145,378
29,2025-09-19T17:47:06.249333,How can I ensure that my doctor understands my learning disability and the specific ways it affects my ability to communicate about PrEP?,how can i ensure tat my doctor understands my learning d154b1l17y and the specific ways like it affects my ability to communicate about prep,"It's important to communicate your needs clearly to your doctor. You might start by explaining your learning disability in simple terms, mentioning how it affects your ability to process medical information or express your concerns. Consider writing down your thoughts or questions before your appointment. You can also ask the doctor to explain things in a different way or provide written information. Don't hesitate to bring a friend or family member for support if that helps. Remember, good healthcare providers want to understand and help you. If you're feeling anxious, talking to a mental health professional can also be beneficial. You're not alone in this!",245,116,361
30,2025-09-19T17:47:11.230507,What specific questions should I prepare to ask my doctor about PrEP?,what specific i mean questions should i prepare to ask my doctor about prep ü§î,"It's great that you want to be prepared for your doctor visit! Here are some questions you might consider asking about PrEP:

1. What is PrEP, and how does it work?
2. Are there different forms of PrEP, like oral and injectable?
3. Who should consider taking PrEP?
4. What are the potential side effects?
5. How often do I need to get tested while on PrEP?
6. How do I take oral PrEP, and how often do I get the injectable form?
7. Can you help me understand my insurance coverage for PrEP?

Feel free to write these down and bring them to your appointment. It‚Äôs important that you feel comfortable expressing your needs!",231,144,375
