turn,timestamp_utc,clean_user,noisy_user,bot,usage.prompt,usage.completion,usage.total
1,2025-09-19T17:22:23.195080,"I had a one-night stand recently and I'm really worried about HIV. Should I consider PrEP, and how can I even get it without a stable address?",i had a one-night stand recently and I'm really w0rri3d about HIV Should I conedier PrEP like and how can I even gst it without a stable aaaddress,"It's understandable to feel worried after a one-night stand. PrEP (pre-exposure prophylaxis) is a preventive medication for people at high risk of HIV, and it comes in both oral and injectable forms. You can access PrEP through healthcare providers, clinics, or community health organizations, many of which may not require a stable address.

If you're feeling anxious about your situation, consider reaching out to a healthcare provider or a local HIV prevention organization. They can offer confidential support and guide you through your options, ensuring your safety and well-being. Remember, you‚Äôre not alone in this, and there are resources available to help you.",276,127,403
2,2025-09-19T17:22:28.061569,¬øExisten formas de obtener PrEP sin que mi pareja se entere y sin ponerme en riesgo?,¬øwxisten formas de obten3r rPEP sin que mi pareja se entere y sin ponerme en riesgo?,"Es comprensible que te sientas as√≠, y tu seguridad es muy importante. La PrEP (profilaxis previa a la exposici√≥n) se puede obtener de forma discreta. Puedes acudir a centros de salud, cl√≠nicas de VIH o servicios de salud sexual, donde tu informaci√≥n ser√° confidencial. Tambi√©n hay servicios de telemedicina que pueden ofrecerte consultas en l√≠nea.

Recuerda que la salud mental es igual de importante. Si sientes que la situaci√≥n es abrumadora, considera hablar con un profesional que pueda apoyarte. Hay recursos disponibles para ayudarte a manejar tanto tu salud sexual como la situaci√≥n en tu relaci√≥n. Cuidarte es una prioridad.",263,131,394
3,2025-09-19T17:22:31.740371,¬øHay cl√≠nicas en Colombia que ofrezcan PrEP de manera confidencial y sin preguntas complicadas?,¬øaHy cl√≠nicas en Colombia qu3 ofrezzzcan PrPE de manera confidencial y sin preugntas complicadas? üòï,"Entiendo que te sientes preocupada y es completamente v√°lido. En Colombia, hay cl√≠nicas y centros de salud que ofrecen PrEP de manera confidencial. Puedes buscar organizaciones locales como la Fundaci√≥n Hombres por la Igualdad o la Fundaci√≥n Ecu√°frica, que suelen tener informaci√≥n sobre servicios de salud sexual y PrEP. 

Recuerda que tu bienestar es importante, y buscar apoyo en un entorno seguro es fundamental. Si sientes que tu relaci√≥n es peligrosa, considera hablar con un profesional o una l√≠nea de ayuda que pueda brindarte apoyo emocional y recursos. Tu seguridad y salud son prioritarias.",266,121,387
4,2025-09-19T17:22:35.422683,¬øExisten opciones de apoyo psicol√≥gico para mujeres que est√°n considerando PrEP en situaciones de violencia de pareja?,¬øExisten opciones de apoyo psicol√≥gico para mujeres qhe est√°n c0n51d3r4nd0 PrEP en sitauciones de violencia de pareja? ‚ùì,"S√≠, existen opciones de apoyo psicol√≥gico para mujeres en situaciones de violencia de pareja. Es fundamental priorizar tu seguridad y bienestar emocional. Puedes buscar organizaciones locales que ofrezcan asesor√≠a y apoyo a v√≠ctimas de violencia, as√≠ como grupos de apoyo espec√≠ficos para mujeres que est√°n considerando PrEP o temas de salud sexual. Tambi√©n hay l√≠neas de ayuda donde puedes hablar con profesionales capacitados en salud mental y violencia de g√©nero. No est√°s sola y es importante que tengas acceso a la ayuda que necesitas. Si te sientes en peligro, considera contactar a servicios de emergencia o refugios en tu √°rea.",273,117,390
5,2025-09-19T17:22:39.325034,¬øD√≥nde puedo encontrar organizaciones locales que ofrezcan apoyo psicol√≥gico y recursos sobre PrEP en mi √°rea?,¬ød√≥nde puedo encontrar 0rgan1z4c10n35 loclaes que ofrezcan apoyo psicol√≥gico y recursos sobre pdep en mi √°rea,"Es comprensible que busques apoyo en esta situaci√≥n. Puedes buscar organizaciones locales que ofrezcan recursos sobre PrEP y apoyo psicol√≥gico. En Colombia, algunas opciones son: 

1. **Fundaci√≥n Sida Estudio y Prevenci√≥n**: ofrecen informaci√≥n sobre VIH y PrEP.
2. **Red de Mujeres Positivas**: brindan apoyo y recursos para mujeres en situaciones dif√≠ciles.
3. **Centros de salud locales**: muchos tienen programas de salud sexual y pueden proporcionarte informaci√≥n sobre PrEP y apoyo emocional.

Tambi√©n considera contactar una l√≠nea de ayuda psicol√≥gica en tu √°rea, donde puedas hablar con profesionales que entiendan tu situaci√≥n. Tu salud y bienestar son importantes.",271,137,408
6,2025-09-19T17:22:43.781114,¬øQu√© puedo hacer si siento que no puedo hablar con mi pareja sobre mi salud sexual y la posibilidad de tomar PrEP?,¬øQu√© puedo haer si siento que no puedo idk halbar con mi pareja sober mi salud sexual y la posibilidad de tomar PrEP,"Lamento que te sientas as√≠; es completamente normal tener preocupaciones en una situaci√≥n dif√≠cil. La salud sexual es importante, y PrEP puede ser una opci√≥n efectiva para prevenir el VIH. Puedes considerar hablar con un profesional de salud o un consejero, ya que ellos pueden ofrecerte un espacio seguro para discutir tus preocupaciones y opciones. Tambi√©n hay l√≠neas de ayuda y recursos comunitarios que pueden brindarte apoyo emocional y estrategias para abordar tus temores. Tu bienestar es lo m√°s importante, as√≠ que busca el apoyo que necesites.",265,108,373
7,2025-09-19T17:22:47.805815,¬øExisten recursos confidenciales en Colombia donde pueda obtener m√°s informaci√≥n sobre PrEP sin que mi pareja lo sepa?,"¬øexisten recur505 confidenciales en colombia donde pueda obtener ,√°s informaci√≥n sobre prep 51n que mi you know pareja l0 sepa? ü§î","Es comprensible que te sientas preocupada por la confidencialidad y la seguridad en tu situaci√≥n. En Colombia, hay centros de salud y organizaciones que ofrecen servicios de salud sexual, incluyendo informaci√≥n sobre PrEP, de manera confidencial. Puedes buscar cl√≠nicas de salud sexual o programas de prevenci√≥n del VIH en tu √°rea. Tambi√©n hay l√≠neas de ayuda y organizaciones como la Secretar√≠a de Salud que pueden proporcionarte informaci√≥n sin que tu pareja lo sepa. Si sientes que tu seguridad est√° en riesgo, considera hablar con un profesional que pueda apoyarte emocionalmente. Tu bienestar es lo m√°s importante.",271,119,390
8,2025-09-19T17:22:52.163565,¬øHay alguna manera de acceder a PrEP sin que mi pareja se entere de mi decisi√≥n?,¬øhay alguna manera de acceder a prep sin que mi pareja se entefe de you know mi decisi√≥n ü´†,"Entiendo que te sientas preocupada por tu seguridad y por la posible reacci√≥n de tu pareja. Es importante priorizar tu salud y bienestar. Puedes considerar acceder a PrEP a trav√©s de cl√≠nicas de salud donde la informaci√≥n se maneja de forma confidencial. Adem√°s, hay opciones de PrEP oral y PrEP inyectable, que pueden adaptarse a tus necesidades y estilo de vida. Te animo a buscar apoyo en profesionales de la salud o en organizaciones que se especializan en salud sexual y violencia de pareja. No est√°s sola, y hay recursos disponibles para ayudarte a tomar decisiones seguras y informadas.",261,125,386
9,2025-09-19T17:22:55.643814,¬øExisten recursos o l√≠neas de ayuda en Colombia que puedan ofrecerme apoyo en esta situaci√≥n?,¬øExisten recusos o l√≠neas de ayuda en Coolmbia qur puedan ofrecerme apoyo en esta situaci√≥n?,"S√≠, en Colombia hay recursos disponibles para brindarte apoyo. Puedes contactar a la l√≠nea de atenci√≥n de la Secretar√≠a de Salud de tu localidad, donde ofrecen asistencia sobre temas de salud sexual y violencia. Tambi√©n puedes comunicarte con la L√≠nea 155, que es una l√≠nea nacional de atenci√≥n para casos de violencia de g√©nero. Adem√°s, organizaciones como Sisma Mujer y la Red Nacional de Mujeres ofrecen apoyo emocional y asesor√≠a. Es importante que busques ayuda en un entorno seguro y te sientas apoyada. Recuerda que tu bienestar es lo m√°s importante.",260,111,371
10,2025-09-19T17:22:59.814997,¬øHay alguna manera de acceder a PrEP de forma discreta para no levantar sospechas en mi pareja?,¬øHay agluna manea de acceder a PrEP de forma discreta para you know no levantar sospechas en mi apreja?,"Entiendo que te sientas as√≠, y es importante priorizar tu salud y bienestar. Existen opciones para acceder a PrEP, tanto en forma oral como inyectable, y muchos centros de salud ofrecen servicios confidenciales. Puedes investigar cl√≠nicas locales que tengan pol√≠ticas de privacidad estrictas o buscar recursos en l√≠nea. Tambi√©n es fundamental hablar con un profesional de la salud que pueda ofrecerte m√°s informaci√≥n y apoyo. Si sientes que la situaci√≥n con tu pareja es peligrosa, considera contactar a una l√≠nea de ayuda o a un refugio que pueda brindarte orientaci√≥n y apoyo en tu situaci√≥n. Tu seguridad es lo m√°s importante.",266,126,392
11,2025-09-19T17:23:03.200947,¬øExisten recursos o l√≠neas de ayuda en Colombia que me puedan asesorar sobre c√≥mo acceder a PrEP sin que mi pareja lo sepa?,¬øExisten recursos o l√≠neas de ayuda en Colombia que me upedan asesorar sobre c√≥mo acceder a PrEP sin qud mi pareja lo sepa?,"Entiendo que te sientas preocupada por tu seguridad y privacidad. En Colombia, hay organizaciones que ofrecen apoyo y orientaci√≥n sobre PrEP y salud sexual. Puedes comunicarte con la L√≠nea de Atenci√≥n del Ministerio de Salud al 192, donde te pueden guiar de manera confidencial. Adem√°s, organizaciones como el Programa Nacional de VIH/SIDA y algunas ONG locales pueden brindarte informaci√≥n y recursos espec√≠ficos. Recuerda que tu bienestar es importante y es v√°lido buscar ayuda. Si tambi√©n sientes que la situaci√≥n con tu pareja es peligrosa, considera contactar a una l√≠nea de apoyo para v√≠ctimas de violencia. Tu seguridad es primordial.",269,125,394
12,2025-09-19T17:23:06.832623,¬øHay alguna forma de obtener PrEP en lugares donde mi pareja no pueda verme o saberlo?,¬øHay alguna uh forma de obtener PrEP 3n lugares donde mi pareja ho pueda vere o saberlo?,"Entiendo que te sientes en una situaci√≥n dif√≠cil y preocupante. Es importante priorizar tu salud y bienestar. Puedes considerar hablar con un profesional de salud en un centro que ofrezca servicios confidenciales, como cl√≠nicas de salud sexual o centros comunitarios. Muchos lugares permiten consultas discretas y pueden brindarte informaci√≥n sobre PrEP oral o inyectable. Tambi√©n puedes buscar servicios en l√≠nea que ofrezcan consultas virtuales. Tu seguridad emocional y f√≠sica es fundamental, as√≠ que si sientes que tu situaci√≥n es peligrosa, considera buscar apoyo en organizaciones locales que ayuden a personas en relaciones abusivas. No est√°s sola en esto.",261,128,389
13,2025-09-19T17:23:10.403603,¬øExisten cl√≠nicas que ofrezcan PrEP de manera an√≥nima y segura en Colombia?,¬øexisten cl√≠nicas que ofrezcan prep de manera i mean an√≥numa y segura en colombia ü§î ü§î,"S√≠, en Colombia hay cl√≠nicas que ofrecen PrEP de manera an√≥nima y segura. Muchas de estas cl√≠nicas tienen programas de salud sexual que respetan la privacidad del paciente. Es importante buscar centros de salud que se especialicen en prevenci√≥n de VIH y que ofrezcan atenci√≥n amigable y sin juicio. Si necesitas ayuda para encontrar una cl√≠nica cerca de ti, te recomiendo buscar organizaciones locales que trabajen en salud sexual, ya que pueden brindarte m√°s informaci√≥n y apoyo. Recuerda que tu salud es importante y que hay recursos disponibles para ti.",264,109,373
14,2025-09-19T17:23:13.885294,¬øHay alguna manera de obtener PrEP sin que mi pareja lo sepa?,¬øHay alguna manera de ob7enr PrEP sin qy3 n1 apreja lk sepa?,"Es comprensible que te sientas preocupada por tu seguridad y la situaci√≥n con tu pareja. PrEP (profilaxis previa a la exposici√≥n) se puede obtener de manera confidencial a trav√©s de cl√≠nicas de salud sexual, hospitales o m√©dicos que ofrezcan servicios de salud reproductiva. Puedes preguntar sobre la opci√≥n de recibirlo de forma oral o inyectable, seg√∫n lo que prefieras. 

Si te sientes en peligro o necesitas apoyo, considera hablar con un profesional de la salud o con organizaciones que se especializan en ayudar a personas en relaciones t√≥xicas. Tu bienestar es lo m√°s importante.",261,123,384
15,2025-09-19T17:23:17.340889,¬øExisten recursos o cl√≠nicas en Colombia que ofrezcan PrEP de manera confidencial?,¬øExisten recursos o cl√≠nicas en Colombia que ofrezcan PrEP de manera confiedncial,"S√≠, en Colombia hay cl√≠nicas y organizaciones que ofrecen PrEP de manera confidencial. Puedes buscar servicios de salud sexual en centros de atenci√≥n a la salud, cl√≠nicas de VIH y organizaciones no gubernamentales que se especializan en salud sexual. Muchos de estos lugares tienen programas para ofrecer servicios de manera segura y discreta. Adem√°s, la l√≠nea de atenci√≥n al VIH en Colombia puede ser un recurso √∫til para obtener m√°s informaci√≥n y apoyo. Si te sientes abrumada, considera hablar con un profesional de la salud mental que pueda ofrecerte apoyo emocional en esta situaci√≥n. Tu bienestar es importante.",258,118,376
16,2025-09-19T17:23:20.431148,¬øC√≥mo puedo acceder a esos servicios sin que mi pareja se entere?,¬øC√≥mo puedo acceder a esos serivcios sin que mi paaareja uh se ntere?,"Entiendo que te sientas preocupada por tu seguridad y la posibilidad de que tu pareja reaccione negativamente. Es importante cuidar de tu salud y bienestar. Puedes acceder a servicios de salud sexual de manera discreta. Busca cl√≠nicas locales o centros de salud comunitarios que ofrezcan servicios de PrEP. Muchas veces, ofrecen citas confidenciales y puedes pedir informaci√≥n sin necesidad de revelar detalles personales. Tambi√©n puedes considerar hablar con un profesional de salud mental, que puede ofrecerte apoyo para manejar la situaci√≥n en la que te encuentras. Tu bienestar es lo m√°s importante.",257,116,373
17,2025-09-19T17:23:23.729195,¬øExisten opciones de PrEP que puedan obtenerse de forma an√≥nima o sin identificaci√≥n?,¬øExisten opciones de PrEP que puedan obtenerse de pfrm4 an√≥nima o sin identificaci√≥n?,"Entiendo tus preocupaciones y el contexto en el que te encuentras. En algunos lugares, puedes encontrar servicios de salud que ofrecen PrEP de manera an√≥nima o sin identificaci√≥n, aunque esto var√≠a seg√∫n la regi√≥n. Te recomiendo buscar cl√≠nicas de salud sexual o centros comunitarios locales que se enfoquen en la prevenci√≥n del VIH, ya que pueden tener opciones m√°s accesibles y confidenciales. 

Es importante priorizar tu salud, pero tambi√©n tu seguridad emocional y f√≠sica. Si sientes que est√°s en una situaci√≥n de violencia, considera contactar a organizaciones de apoyo que puedan ofrecerte ayuda. Tu bienestar es fundamental.",260,123,383
18,2025-09-19T17:23:28.996461,¬øCu√°les son los pasos para acceder a PrEP de manera segura en un entorno donde no me siento protegida?,¬øCu√°les son lo5 pasos para acceder a PrEP de manera seura en un entorno donde no me siento protegida?,"Entiendo que te sientas preocupada por tu seguridad en esta situaci√≥n. Aqu√≠ hay algunos pasos que podr√≠as considerar:

1. **Inf√≥rmate sobre PrEP**: Conoce m√°s sobre las opciones orales e inyectables, as√≠ como sus beneficios y c√≥mo se utilizan.
2. **Busca apoyo**: Habla con un profesional de la salud o un consejero de confianza. Ellos pueden ofrecerte informaci√≥n y apoyo sin juzgarte.
3. **Consulta en un lugar seguro**: Si es posible, elige un lugar donde te sientas protegida para tus citas.
4. **Considera la confidencialidad**: Pregunta sobre la privacidad de tu informaci√≥n m√©dica al buscar servicios de PrEP.
5. **Con√©ctate con recursos de apoyo**: Busca organizaciones locales que ofrezcan asesoramiento y asistencia para personas en relaciones dif√≠ciles. 

Tu bienestar es importante, y hay recursos disponibles para ayudarte.",262,192,454
19,2025-09-19T17:23:32.940939,¬øExisten maneras de obtener PrEP sin que mi pareja lo sepa y manteniendo mi seguridad?,like ¬øExist3n maneras de obtener PrEP sin que mi pareja lo sepa y manteniendo mj seguridad,"Entiendo que te sientes atrapada en una situaci√≥n dif√≠cil y que priorizar tu salud y seguridad es fundamental. Existen maneras de acceder a PrEP de forma discreta. Puedes buscar cl√≠nicas de salud sexual que ofrezcan servicios confidenciales o considerar la opci√≥n de obtener PrEP oral o inyectable en farmacias que respeten tu privacidad. Tambi√©n puedes hablar con un profesional de salud, quien puede ofrecerte apoyo y recursos adaptados a tu situaci√≥n. Si te sientes insegura o necesitas ayuda, considera contactar a organizaciones que apoyan a personas en relaciones t√≥xicas. Tu bienestar es importante.",260,123,383
20,2025-09-19T17:23:36.563685,¬øD√≥nde puedo encontrar cl√≠nicas que ofrezcan PrEP de manera confidencial en Colombia?,¬øDn√≥de pudo encontrar cp√≠nicas que ofrezcan orEP de anera confidencial en Colombia üò¨,"Entiendo que te sientes preocupada y es completamente v√°lido buscar informaci√≥n sobre tu salud. En Colombia, puedes encontrar cl√≠nicas que ofrecen PrEP de manera confidencial en instituciones de salud p√∫blica, cl√≠nicas de VIH y organizaciones no gubernamentales. Te recomiendo buscar en sitios web como el Ministerio de Salud o contactar organizaciones locales que trabajen en salud sexual. Tambi√©n es importante que hables con un profesional de la salud que pueda brindarte apoyo en un ambiente seguro. Recuerda, tu bienestar es una prioridad y hay recursos disponibles para ayudarte. Si sientes que tu seguridad est√° en riesgo, considera hablar con un profesional en temas de violencia de pareja.",262,129,391
21,2025-09-19T17:23:40.915458,¬øQu√© medidas de seguridad puedo tomar para buscar informaci√≥n sobre PrEP sin que mi pareja lo descubra?,¬øsu√© medidas de 53gur1d4d puedo tomar para buscar informaci√≥n sobre PrEP sin que mi pareja lo descubra?,"Entiendo que te sientes en una situaci√≥n dif√≠cil. Es importante priorizar tu salud y bienestar. Para buscar informaci√≥n sobre PrEP sin que tu pareja lo descubra, puedes considerar lo siguiente:

1. **Usar dispositivos privados**: Busca informaci√≥n en lugares donde tu pareja no tenga acceso, como tu tel√©fono o computadora personal.
2. **Visitar cl√≠nicas de salud**: Muchas cl√≠nicas ofrecen servicios confidenciales y pueden proporcionarte informaci√≥n sobre PrEP.
3. **L√≠neas de ayuda**: Algunas organizaciones ofrecen asesor√≠a telef√≥nica an√≥nima sobre salud sexual.

Recuerda que tu seguridad emocional y f√≠sica es prioritaria. Si sientes que est√°s en peligro, considera contactar a un profesional o una l√≠nea de ayuda para orientaci√≥n. No est√°s sola en esto.",266,154,420
22,2025-09-19T17:23:44.659464,¬øExisten servicios de salud en Colombia que ofrezcan PrEP de forma confidencial y segura?,¬øExisten servicios de salud eeen Colombia que ofrezcan PrEP de forma confidencial y segura?,"S√≠, en Colombia hay servicios de salud que ofrecen PrEP de manera confidencial y segura. Muchas cl√≠nicas y organizaciones enfocadas en la salud sexual brindan asesor√≠a y acceso a PrEP, tanto en su forma oral como inyectable. Es importante que busques un lugar que te haga sentir c√≥moda y segura. Tambi√©n puedes considerar hablar con un profesional de la salud que entienda tus preocupaciones, incluyendo el contexto de tu relaci√≥n. Recuerda que tu bienestar emocional y f√≠sico es prioridad. Si sientes que necesitas apoyo, hay l√≠neas de ayuda y organizaciones que pueden ofrecerte asistencia.",260,118,378
23,2025-09-19T17:23:48.039006,¬øHay alguna manera de acceder a PrEP sin que mi pareja lo sepa para protegerme?,¬øHay alguna manera de acceder a PrEP sin que mi pareja lo sepa para protegerme?,"Entiendo que te sientes atrapada y preocupada por tu seguridad. La PrEP, ya sea en forma oral o inyectable, es una opci√≥n efectiva para prevenir el VIH y puede ser solicitada de manera confidencial. En muchos lugares, puedes acceder a servicios de salud que ofrecen PrEP sin necesidad de que tu pareja est√© involucrada. Es importante priorizar tu salud y bienestar. Considera buscar apoyo profesional, como un consejero o una organizaci√≥n comunitaria, que pueda ofrecerte orientaci√≥n y ayudarte a enfrentar tus preocupaciones de manera segura. No est√°s sola en esto.",258,118,376
24,2025-09-19T17:23:51.262869,¬øD√≥nde puedo encontrar servicios de salud que ofrezcan PrEP de manera confidencial en mi √°rea?,¬øD√≥nde um puedo encontrar servicios ds salud que ofrezczn PrEP de maaanera confidencial en mi √°r3a?,"Entiendo que puede ser dif√≠cil buscar atenci√≥n m√©dica en una situaci√≥n complicada. Te recomiendo buscar cl√≠nicas de salud sexual o centros comunitarios en tu √°rea que ofrezcan servicios de PrEP. Muchas de estas cl√≠nicas tienen pol√≠ticas de confidencialidad para proteger tu informaci√≥n. Tambi√©n puedes contactar l√≠neas de ayuda locales o organizaciones que se especializan en salud sexual; ellos pueden proporcionarte recursos y apoyo. Si necesitas hablar de tus preocupaciones emocionales o de seguridad, considera tambi√©n buscar apoyo de profesionales en salud mental. Tu bienestar es importante y hay personas dispuestas a ayudarte.",265,112,377
25,2025-09-19T17:23:54.407056,¬øExisten opciones de PrEP que no requieran que hable con mi pareja sobre mi salud sexual?,¬øExisten opcuones de PrEP que no requieran que hable con mi pardja sobre m1 salud sexuwl?,"S√≠, existen opciones de PrEP que puedes considerar. Hay PrEP oral, que debes tomar diariamente, y tambi√©n PrEP inyectable, que se administra cada dos meses. Es importante que te sientas segura y c√≥moda al tomar decisiones sobre tu salud. Si sientes que hablar con tu pareja podr√≠a ser peligroso, busca un profesional de la salud que pueda ofrecerte orientaci√≥n y apoyo en un ambiente seguro. Tambi√©n hay recursos y l√≠neas de ayuda para personas en situaciones de violencia. Tu salud y bienestar son lo m√°s importante.",266,107,373
26,2025-09-19T17:23:57.820212,¬øD√≥nde puedo encontrar un profesional de la salud que me brinde apoyo sobre PrEP sin que mi pareja lo sepa?,¬ød√≥nde puedo encontrar un profesional de ls salud que me brinde apyoo sobre prep sin que mi pareja lo sepa? üôÇ,"Entiendo que te sientes en una situaci√≥n dif√≠cil y es importante priorizar tu salud y bienestar. Puedes buscar cl√≠nicas de salud sexual en tu √°rea que ofrezcan servicios de PrEP. Muchas veces, estas cl√≠nicas tienen pol√≠ticas de confidencialidad y pueden proporcionarte atenci√≥n sin que tu pareja se entere. Tambi√©n puedes considerar contactar l√≠neas de ayuda locales o grupos de apoyo para obtener recomendaciones. Si te sientes en peligro, no dudes en buscar recursos de apoyo para la violencia en la relaci√≥n. Tu seguridad es lo m√°s importante.",266,106,372
27,2025-09-19T17:24:01.366297,¬øExisten opciones para acceder a PrEP de manera an√≥nima o sin necesidad de que mi pareja lo descubra?,¬øExisten opciones para acceder a PrEP de manera an√≥nima o sin necesidad de que mi pareja lo descubra?,"Entiendo que te sientes en una situaci√≥n complicada y es importante priorizar tu seguridad. Existen opciones para acceder a PrEP de manera m√°s privada. Puedes acudir a cl√≠nicas de salud sexual, donde a menudo puedes recibir atenci√≥n sin necesidad de revelar informaci√≥n personal. Tambi√©n hay servicios en l√≠nea que ofrecen consultas y recetas para PrEP. 

Recuerda que tanto la PrEP oral como la inyectable pueden ser opciones efectivas para protegerte del VIH. Si sientes miedo por tu relaci√≥n, considera hablar con un profesional o buscar recursos de apoyo que te ayuden a manejar tu situaci√≥n. Tu bienestar es lo m√°s importante.",263,125,388
28,2025-09-19T17:24:06.475392,¬øQu√© recursos o l√≠neas de apoyo puedo contactar para recibir ayuda sobre mi situaci√≥n y aprender m√°s sobre PrEP sin arriesgarme?,¬øQu√© recurrrsos o l√≠neaaas de apoyo puedo contactra para recibir ayuda skbre mi situaci√≥n y aprender m√°s sobre PrEP 51n arriesgarme?,"Lamento que est√©s pasando por esta situaci√≥n dif√≠cil. Es importante priorizar tu seguridad y bienestar. Para aprender sobre PrEP, puedes contactar a organizaciones de salud locales que ofrezcan servicios confidenciales y apoyo. En Colombia, una opci√≥n es la Asociaci√≥n Colombiana de Infectolog√≠a, que puede brindarte informaci√≥n sobre PrEP y recursos de salud.

Adem√°s, considera buscar l√≠neas de ayuda para v√≠ctimas de violencia, como la L√≠nea 155, donde puedes recibir apoyo emocional y orientaci√≥n. Recuerda que tu salud y seguridad son lo m√°s importante, y hay recursos disponibles para ayudarte.",273,114,387
29,2025-09-19T17:24:09.742564,¬øHay alg√∫n lugar seguro donde pueda recibir informaci√≥n sobre PrEP sin que mi pareja lo descubra?,¬øhay alg√∫n lugar seguro donde pueda recibir informaci√≥n like sobre prep sin que mi pareja lo d35cubr4,"Es comprensible que te sientas as√≠. La seguridad es lo m√°s importante. Puedes buscar cl√≠nicas de salud sexual, organizaciones comunitarias o servicios telef√≥nicos de salud en tu √°rea que ofrezcan informaci√≥n sobre PrEP de manera confidencial. Muchos centros de salud tienen pol√≠ticas de privacidad estrictas, lo que significa que no compartir√°n tu informaci√≥n sin tu consentimiento. Tambi√©n puedes considerar hablar con un profesional de la salud mental que pueda apoyarte en tu situaci√≥n. Recuerda que mereces sentirte segura y cuidar de tu salud. Si necesitas m√°s recursos, puedo ayudarte a encontrarlos.",260,117,377
30,2025-09-19T17:24:13.842943,¬øExisten organizaciones en Colombia que ofrezcan apoyo y recursos para personas en situaciones de violencia que tambi√©n est√©n interesadas en PrEP?,¬øExisten oranizaciones en Colomia que ofrezcan apoyo y recursos para personas en 517uac10n3s de violencia que tambi√©n est√©n interesadas en PrEP? ‚ÄºÔ∏è,"S√≠, en Colombia hay organizaciones que ofrecen apoyo a personas en situaciones de violencia y que tambi√©n pueden brindar informaci√≥n sobre PrEP. Por ejemplo, puedes contactar a la L√≠nea 155, que brinda asesor√≠a y apoyo emocional. Tambi√©n existen ONGs como ""Red Nacional de Mujeres"" y ""SOMOS - Comunidad LGBTI"" que ofrecen recursos y apoyo integral. Es importante cuidar tu bienestar y buscar ayuda profesional. Recuerda que la salud sexual es fundamental y hay opciones como PrEP, tanto oral como inyectable, para protegerte. Tu seguridad emocional y f√≠sica es prioridad.",278,117,395
