turn,timestamp_utc,clean_user,noisy_user,bot,usage.prompt,usage.completion,usage.total
1,2025-09-19T17:27:50.162431,"I had a one-night stand recently and I'm really worried about HIV. Should I consider PrEP, and how can I even get it without a stable address?","i had a ne-night stand recently and 1'm rrreally worried 4b0u7 HIV. Should I consider PrEP, and how can I even get it iwthout a stable idk address? address?","It's understandable to feel anxious after a one-night stand. PrEP, which is available as a daily pill or an injectable option every two months, can be an effective way to reduce your risk of HIV. Many healthcare providers are understanding and supportive, especially regarding concerns about stigma. 

If you’re worried about accessing PrEP due to your housing situation, consider reaching out to local clinics or organizations that specialize in LGBTQ+ health, as they often have resources to help with confidentiality and may not require a stable address. They can also provide support for any mental health concerns you may have. You’re not alone in this, and there are people who can help.",261,131,392
2,2025-09-19T17:27:53.868321,What specific resources or clinics can I reach out to for support with accessing PrEP without a stable address?,what specifoc resourcesss od clinics can I reach out to for support with accessing PrEP without a stable address?,"It’s great that you’re seeking support for accessing PrEP. Many clinics offer services regardless of your housing situation. Look for local health departments, community health centers, or LGBTQ+ clinics, which often provide PrEP and can address your concerns about confidentiality and stigma. 

You might also consider reaching out to organizations like the National LGBTQ Task Force or the AIDS Healthcare Foundation for guidance. They can help connect you to resources and clinics that are supportive and understanding of your situation. Remember, you're not alone, and there are people ready to help you.",240,109,349
3,2025-09-19T17:27:57.358324,What should I expect during my first appointment when discussing PrEP at a LGBTQ+ clinic?,what should i expect during my idk first appointment when discussing prep at a lgbtq+ clinic,"At your first appointment discussing PrEP at an LGBTQ+ clinic, you can expect a supportive and understanding environment. The healthcare provider will likely ask about your sexual health history and any concerns you may have, including your experiences with gender dysphoria. They will explain how PrEP works, covering both oral and injectable options, and discuss the benefits and potential side effects. 

Feel free to express your worries about stigma; most clinics prioritize creating a safe space for all identities. If you're feeling anxious, consider reaching out to mental health professionals who specialize in LGBTQ+ issues for additional support. You're taking a positive step for your health!",236,125,361
4,2025-09-19T17:28:01.084216,What specific questions should I ask my healthcare provider to ensure they understand my experience and concerns related to gender dysphoria while discussing PrEP?,What speicfic qu3stions should I ask my healthcare provider t0 ensure they understand my experience like and concerns reltaed to gender dysphoriiia while discussing PrEP?,"It's great that you want to advocate for yourself! Here are some questions you might consider asking your healthcare provider:

1. How do you approach care for patients with gender dysphoria?
2. What is your experience with prescribing PrEP to non-binary individuals?
3. Can you explain how PrEP can fit into my overall health plan, considering my identity?
4. What support resources do you have for patients dealing with stigma or mental health concerns?
5. How can I ensure my experience and concerns are taken seriously in my care?

Remember, it's important to feel comfortable with your provider. Seeking a supportive environment can help ease your anxiety.",254,129,383
5,2025-09-19T17:28:07.541361,What steps can I take to find a healthcare provider who is knowledgeable and sensitive to my needs around gender dysphoria and PrEP?,what steps um can I take to find a healthcare provider wh0 is knowledgeable and sensitive to my needs arond gender dysphoria and PrEP,"Finding a supportive healthcare provider is important. Here are some steps you can take:

1. **Research LGBTQ+ Friendly Clinics**: Look for clinics that specialize in LGBTQ+ health or are known for their inclusive care. Websites like the Health Resources and Services Administration (HRSA) can help you find them.

2. **Ask for Recommendations**: Reach out to local LGBTQ+ organizations or support groups. They often have lists of providers who are understanding and knowledgeable.

3. **Check Online Reviews**: Look for reviews that mention sensitivity to gender identity and LGBTQ+ issues.

4. **Initial Consultation**: Consider scheduling a consultation to discuss your concerns and assess their sensitivity to your needs.

5. **Be Open About Your Needs**: When you find a provider, communicate your concerns about gender dysphoria and PrEP to see how they respond.

Remember, it's okay to seek out a provider who makes you feel comfortable and understood.",244,187,431
6,2025-09-19T17:28:10.925934,What should I do if I feel uncomfortable or judged during my first appointment with a new healthcare provider?,w-wha should I do if I feel uncomfortable or judged dur1ng my firsg 4pp0intmen7 with you know a new healthcare provider?,"It's completely understandable to feel anxious about a new healthcare appointment, especially regarding sensitive topics. If you feel uncomfortable or judged, you have the right to speak up. You can express your feelings to the provider, or you might choose to seek a different provider who is more affirming and understanding of your situation. 

Consider bringing a supportive friend or advocate if that helps. Remember, you’re not alone, and there are resources available to help navigate these feelings, such as counseling services or support groups. Your health and comfort are important, and you deserve respectful care.",248,112,360
7,2025-09-19T17:28:15.578358,What resources are available to find LGBTQ+-friendly healthcare providers who can help with PrEP?,what resources are available to find LGBTQ+-friendlu healthcare pr0v1d3r5 who can help with PrEP?,"Finding LGBTQ+-friendly healthcare providers is important for accessing PrEP in a supportive environment. You can utilize resources like the following:

1. **The National LGBTQIA+ Health Education Center**: They provide a directory of LGBTQ+-affirming healthcare providers.
   
2. **PrEP Locator**: Use websites like PrEPFacts or GetPrEPed to search for clinics and providers that offer PrEP and are sensitive to LGBTQ+ needs.

3. **Local LGBTQ+ Centers**: Many community organizations have resources and can recommend affirming healthcare providers.

4. **Planned Parenthood**: They offer inclusive services and can help with PrEP prescriptions.

If you feel anxious about stigma, consider reaching out to mental health professionals who specialize in LGBTQ+ issues for support.",241,153,394
8,2025-09-19T17:28:18.733692,How can I approach a healthcare provider about starting PrEP without feeling judged?,how c4n I approach 4 healthcare provider about starting Pr3P without feeling judged,"It's completely understandable to feel anxious about discussing PrEP with a healthcare provider, especially when navigating gender dysphoria. Consider finding a provider who specializes in LGBTQ+ health or is known for being affirming and supportive. You might start the conversation by expressing your concerns about stigma and your desire for a safe, non-judgmental space. Remember, healthcare providers are there to help, and discussing your needs openly can foster a better relationship. If you feel overwhelmed, reaching out to local LGBTQ+ organizations can provide additional support and recommendations. You're not alone in this journey!",233,114,347
9,2025-09-19T17:28:24.370965,What specific questions should I ask to ensure my healthcare provider understands my needs related to PrEP and gender dysphoria?,w-what specific questions 5h0uld I ask to ensure my healthcare provider understands my needs r3la73d to PrEP and gender dypshoria,"It's great that you're preparing to advocate for yourself! Here are some questions you can ask your healthcare provider:

1. How do you support patients with gender dysphoria in accessing PrEP?
2. Can you explain how PrEP works and its relevance to my specific situation?
3. What measures do you have in place to ensure a non-judgmental environment for patients?
4. Are there resources available for patients who may experience mental health challenges related to gender dysphoria?
5. How can we work together to create a care plan that respects my identity and needs?

Remember, it's important to feel comfortable with your provider. Seeking support from local LGBTQ+ organizations can also be helpful.",248,139,387
10,2025-09-19T17:28:28.745733,What should I do if I feel uncomfortable with my healthcare provider's response to my questions about PrEP?,what should I do if I feel uncomf0r74b3l with my healthcare provider's response to my questions about Pr3P? 💀,"It's completely valid to feel uncomfortable, especially when discussing sensitive topics like PrEP and your identity. If your healthcare provider doesn't respond in a way that feels supportive or respectful, consider these options: 

1. **Seek a different provider**: Look for healthcare professionals who specialize in LGBTQ+ health or have experience with gender dysphoria. They may be more understanding. 

2. **Bring a friend or advocate**: Having someone with you can help you feel more comfortable during appointments. 

3. **Research**: Gather information from reliable resources about PrEP, its benefits, and how it works. 

If you're feeling overwhelmed, speaking with a mental health professional can also be beneficial. You deserve to be treated with respect and understanding!",247,148,395
11,2025-09-19T17:28:32.015382,How can I find a healthcare provider who is affirming and knowledgeable about both PrEP and gender dysphoria?,how can 1 find a healthcare providre who is affirming and knowledgeable baout bo7h PrEP and gender uh dysphoria? dysphoria?,"Finding a healthcare provider who is affirming and knowledgeable about both PrEP and gender dysphoria can be a bit challenging, but there are resources to help. Consider looking for LGBTQ+ health clinics in your area; they often have providers trained in gender-affirming care and sexual health. Websites like the Human Rights Campaign or the Fenway Institute offer directories of inclusive healthcare providers. It’s also helpful to reach out to local LGBTQ+ organizations for recommendations. Remember, you deserve compassionate care, and there are professionals who understand your needs. If you ever feel overwhelmed, talking to a counselor or therapist experienced in gender identity can also provide support.",248,128,376
12,2025-09-19T17:28:36.103828,What specific questions should I ask a potential healthcare provider to ensure they are supportive of my identity and knowledgeable about PrEP?,Waht specific questions should I ask a potential healthcare pr0vid3r tk ensure they are supportive 0f my identity anddd knowledgeable abot PrEP?,"It's great that you're seeking a supportive healthcare provider. Here are some questions you might consider asking:

1. How do you approach providing care for LGBTQ+ patients, including non-binary individuals?
2. Can you share your experience with prescribing PrEP, both oral and injectable?
3. How do you handle concerns about stigma or discrimination in your practice?
4. What resources do you have for patients who may feel anxious about accessing PrEP?
5. How do you ensure patient confidentiality and a safe environment for discussing sensitive topics?

Finding a provider who respects your identity and understands PrEP can help ease your concerns. If you ever feel overwhelmed, consider reaching out to mental health professionals or support groups that specialize in LGBTQ+ issues.",248,145,393
13,2025-09-19T17:28:39.365332,What are some local resources or clinics that specifically cater to non-binary individuals seeking PrEP?,Wha7 arrre some local resources or cljnics that specifically cater 70 you know non-binary individuals seeking PrEP ❓,"It's great that you're seeking information about PrEP! Many clinics and organizations focus on providing inclusive care for non-binary and LGBTQ+ individuals. You can start by looking for local LGBTQ+ health centers or community clinics, as they often offer PrEP services and are trained to provide supportive care. 

Resources like the National LGBTQ Task Force or your local health department can help you find inclusive providers. Additionally, organizations like the Gay Men's Health Crisis (GMHC) or the Center for Transgender Equality may have specific recommendations. Don’t hesitate to reach out to them for guidance tailored to your needs. Remember, you deserve compassionate care!",243,125,368
14,2025-09-19T17:28:43.931290,How can I approach a healthcare provider about PrEP without feeling judged or misunderstood?,how can 1 approach a healthcare provider 4b0u7 PdEP without feeling ujdh3d od m15under570od,"It's completely understandable to feel anxious about approaching a healthcare provider about PrEP, especially with concerns about stigma. Here are a few tips: 

1. **Research Providers**: Look for clinics or providers known for being LGBTQ+ friendly or inclusive. Many organizations prioritize understanding diverse identities.

2. **Prepare Questions**: Write down your questions or concerns ahead of time. This can help guide the conversation.

3. **Be Direct**: You can simply say, “I’m interested in PrEP and I want to discuss my options.” 

4. **Seek Support**: If possible, bring a trusted friend or support person with you.

Remember, your health and well-being are important, and you deserve understanding and respect. If feelings of anxiety persist, consider reaching out to a mental health professional for support.",243,162,405
15,2025-09-19T17:28:47.904284,What are some resources or organizations that specifically support non-binary individuals seeking PrEP?,what are somr resources od organizations that specifically support non-b1n4ry individuals seeking i mean prep?,"There are several organizations that specifically support non-binary individuals and can help with accessing PrEP:

1. **Transgender Law Center** - Provides resources and advocacy for transgender and non-binary individuals, including healthcare access.

2. **GLMA (Gay and Lesbian Medical Association)** - Offers a provider directory where you can find inclusive healthcare providers knowledgeable about PrEP.

3. **The Trevor Project** - While primarily focused on mental health, they can connect you to resources regarding sexual health and PrEP.

4. **Planned Parenthood** - Many clinics offer inclusive services and can help with PrEP access while addressing any concerns about stigma.

Remember, seeking support from professionals who understand your experience can make a difference.",237,143,380
16,2025-09-19T17:28:52.485033,What steps can I take to find a healthcare provider who understands my gender identity and is knowledgeable about PrEP?,what steps can I take to find a h34l7hcar3 provider who understands my gend3r identity and is knowledgeable about PrEP?,"Finding a healthcare provider who understands your gender identity and is knowledgeable about PrEP is important. Here are some steps you can take:

1. **Research Local Clinics**: Look for LGBTQ+ friendly clinics or organizations in your area, as they often have providers experienced with diverse identities.

2. **Ask for Recommendations**: Reach out to local LGBTQ+ support groups or online forums to get recommendations for inclusive providers.

3. **Check Credentials**: When you identify potential providers, check their websites or call to ask if they have experience with gender diversity and PrEP.

4. **Consult Resources**: Organizations like the Human Rights Campaign or Planned Parenthood can help you find inclusive care.

5. **Schedule a Consultation**: Consider meeting with a provider to discuss your concerns before committing to care.

Remember, you deserve respectful and affirming healthcare!",246,168,414
17,2025-09-19T17:28:55.720597,What should I say to a healthcare provider when I first talk to them about my concerns regarding PrEP and my gender identity?,wh47 should I say go a h3l47hc4re provider when I first talk to them about my concerns regarding PrEP and my gender idnetity,"When you talk to a healthcare provider about PrEP and your gender identity, consider saying something like, “I’m interested in learning more about PrEP for HIV prevention, and I’d like to discuss this in relation to my gender identity.” This opens the conversation and allows you to express your needs. If you feel anxious, it might help to write down your thoughts beforehand. Remember, you deserve respectful and understanding care. If you encounter any stigma or feel uncomfortable, seeking support from LGBTQ+ organizations or mental health professionals can be beneficial. You’re not alone in this journey.",248,115,363
18,2025-09-19T17:28:59.514526,What resources are available to help me find supportive healthcare providers who understand LGBTQ+ issues?,W-What resources are available ttto hrlppp m3 find supportive healthcare providers who understand LGBTQ+ issues?,"It's great that you're seeking supportive healthcare. You can start by looking into local LGBTQ+ health centers or clinics, as they often have providers experienced in addressing gender identity and sexual health. Organizations like the Human Rights Campaign (HRC) and the National LGBTQ Task Force offer directories for inclusive healthcare providers. Additionally, the Gay and Lesbian Medical Association (GLMA) can help you find LGBTQ+-friendly doctors. Don’t hesitate to reach out to these resources; they’re there to support you. If you’re feeling overwhelmed, talking to a mental health professional who understands LGBTQ+ issues can also be beneficial. You're not alone in this.",239,125,364
19,2025-09-19T17:29:04.388873,How can I approach a healthcare provider about starting PrEP without feeling judged?,how can uh i approach a healthcare pr0v1d3r abouuut starting prep without feeling judged? judged?,"It's completely understandable to feel anxious about approaching a healthcare provider for PrEP, especially with concerns about judgment. Here are some tips to help you feel more comfortable:

1. **Do Your Research**: Educate yourself about PrEP, both oral and injectable options. Knowledge can empower you during discussions.

2. **Find a Supportive Provider**: Look for healthcare providers who specialize in LGBTQ+ care. They may be more understanding and accepting.

3. **Bring a Support Person**: If possible, take a friend or ally with you for emotional support.

4. **Be Direct**: You can start by saying you're looking for a non-judgmental space to discuss your health.

If you feel overwhelmed, consider reaching out to a mental health professional or local LGBTQ+ support groups for guidance. You're not alone in this!",240,167,407
20,2025-09-19T17:29:08.547421,What should I do if I feel uncomfortable with the healthcare provider I initially approach for PrEP?,Wht should I do if I feeeel uncomfortable wuth 7h3 healthcare provider I initially approach for PrEl PrEl,"It's completely understandable to feel uncomfortable with a healthcare provider. If you find yourself in that situation, consider these steps: 

1. **Trust Your Feelings**: If you feel judged or misunderstood, it’s okay to seek another provider who may be more supportive and knowledgeable about your needs.
2. **Seek Recommendations**: Look for healthcare providers who have experience with LGBTQ+ communities or specialize in gender-affirming care.
3. **Contact Support Organizations**: Organizations like the LGBTQ+ Health Initiative or local health clinics can provide referrals and support.
4. **Prepare for Visits**: Having questions written down can help guide your conversation and ensure you get the information you need.

Remember, prioritizing your comfort and well-being is important.",242,148,390
21,2025-09-19T17:29:13.261473,What are the best resources for finding LGBTQ+ friendly healthcare providers who understand PrEP?,what are the best resources for i mean findibg lbgggtq+ friendly he4l7hc4re providers who understad prep?,"Finding LGBTQ+ friendly healthcare providers is essential for accessing PrEP comfortably. Here are some resources that can help:

1. **LGBTQ+ Health Access Initiative**: This organization helps connect individuals with supportive healthcare providers in your area.
  
2. **PrEP Locator**: Websites like PrEP Locator (prepmap.org) can help you find clinics that offer PrEP and cater to LGBTQ+ communities.

3. **Local LGBTQ+ Centers**: Many cities have LGBTQ+ community centers that provide resources, referrals, and support.

4. **The National LGBTQ+ Health Education Center**: They offer training for providers to improve care for LGBTQ+ patients.

It's important to find a provider you feel comfortable with, so don’t hesitate to reach out and ask questions about their experience with PrEP and understanding of gender identity.",245,165,410
22,2025-09-19T17:29:17.436674,How can I prepare for my first appointment to discuss PrEP without feeling overwhelmed by my gender identity concerns?,how can i prepare for my first appointment to uh dscuss prpe without feeling overwhelmed by my gender idenrity concerns? ✨,"It's completely understandable to feel anxious about discussing PrEP, especially when navigating gender identity concerns. To prepare for your appointment, consider writing down your questions or concerns about PrEP, which can help you stay focused. Bring a supportive friend if it helps, or consider calling ahead to discuss your identity with the provider, ensuring they understand your needs. Remember, many healthcare professionals are becoming more aware and sensitive to gender diversity. If you feel overwhelmed, talking to a mental health professional can provide additional support. You deserve care that respects your identity.",244,107,351
